# Windows SDK have a lot of symbols that conflict with nim's symbol rule.
# Here is a list for renamed symbols in Winim.

_11 (AccessProc) => 11
_12 (AccessProc) => 12
_13 (AccessProc) => 13
_14 (AccessProc) => 14
_21 (AccessProc) => 21
_22 (AccessProc) => 22
_23 (AccessProc) => 23
_24 (AccessProc) => 24
_31 (AccessProc) => 31
_32 (AccessProc) => 32
_33 (AccessProc) => 33
_34 (AccessProc) => 34
_41 (AccessProc) => 41
_42 (AccessProc) => 42
_43 (AccessProc) => 43
_44 (AccessProc) => 44
__IN__WINERROR_ (Const) => IN_WINERROR
__REQUIRED_RPCSAL_H_VERSION__ (Const) => REQUIRED_RPCSAL_H_VERSION
__RPCNDR_H_VERSION__ (Const) => RPCNDR_H_VERSION
__RPCPROXY_H_VERSION__ (Const) => RPCPROXY_H_VERSION
_AUTHZ_SS_MAXSIZE (Const) => AUTHZ_SS_MAXSIZE
_DRVRESERVED (Const) => VFW_DRVRESERVED
_FORCENAMELESSUNION (Const) => FORCENAMELESSUNION
_INC_MMREG (Const) => INC_MMREG
_NDIS_SWITCH_PORT_ID (Const) => NDIS_SWITCH_PORT_ID
_PHNDLR (ProcType) => PHNDLR
_RICHEDIT_VER (Const) => RICHEDIT_VER
_s_RIFFWAVE_inst (Object) => s_RIFFWAVE_inst
_SearchAssistantEvents (Interface) => SearchAssistantEvents
_SETUPAPI_VER (Const) => SETUPAPI_VER
_SS_ALIGNSIZE (Const) => SS_ALIGNSIZE
_SS_MAXSIZE (Const) => SS_MAXSIZE
_SS_PAD1SIZE (Const) => SS_PAD1SIZE
_SS_PAD2SIZE (Const) => SS_PAD2SIZE
_SVGIO (Type) => SVGIO
_SVSIF (Type) => SVSIF
_VerError (Object) => VerError
ABORTDOC (Const) => abortDoc
Aborted (Const) => aborted
AccessDenied (Const) => accessDenied
AccessReasonAllowedAce (Const) => accessReasonAllowedAce
AccessReasonAllowedParentAce (Const) => accessReasonAllowedParentAce
AccessReasonDeniedAce (Const) => accessReasonDeniedAce
AccessReasonDeniedParentAce (Const) => accessReasonDeniedParentAce
AccessReasonEmptyDacl (Const) => accessReasonEmptyDacl
AccessReasonFromPrivilege (Const) => accessReasonFromPrivilege
AccessReasonIntegrityLevel (Const) => accessReasonIntegrityLevel
AccessReasonMissingPrivilege (Const) => accessReasonMissingPrivilege
AccessReasonNoGrant (Const) => accessReasonNoGrant
AccessReasonNone (Const) => accessReasonNone
AccessReasonNoSD (Const) => accessReasonNoSD
AccessReasonNotGrantedByCape (Const) => accessReasonNotGrantedByCape
AccessReasonNotGrantedByParentCape (Const) => accessReasonNotGrantedByParentCape
AccessReasonNotGrantedToAppContainer (Const) => accessReasonNotGrantedToAppContainer
AccessReasonNullDacl (Const) => accessReasonNullDacl
AccessReasonOwnership (Const) => accessReasonOwnership
AclRevisionInformation (Const) => aclRevisionInformation
AclSizeInformation (Const) => aclSizeInformation
ActivationContextBasicInformation (Const) => activationContextBasicInformation
ActivationContextDetailedInformation (Const) => activationContextDetailedInformation
ActivationContextManifestResourceName (Const) => activationContextManifestResourceName
AdapterType (Const) => adapterType
ADDRESS (Type) => TADDRESS
ADDRESS (Object) => TADDRESS
ADDRESS64 (Object) => TADDRESS64
AddrMode1616 (Const) => addrMode1616
AddrMode1632 (Const) => addrMode1632
AddrModeFlat (Const) => addrModeFlat
AddrModeReal (Const) => addrModeReal
AdjustBlackSaturation (Const) => adjustBlackSaturation
AdjustContrast (Const) => adjustContrast
AdjustDensity (Const) => adjustDensity
AdjustExposure (Const) => adjustExposure
AdjustHighlight (Const) => adjustHighlight
AdjustMidtone (Const) => adjustMidtone
AdjustShadow (Const) => adjustShadow
AdjustWhiteSaturation (Const) => adjustWhiteSaturation
AdministratorPowerPolicy (Const) => administratorPowerPolicy
AE_ACLMOD (Object) => TAE_ACLMOD
AE_CLOSEFILE (Object) => TAE_CLOSEFILE
AE_CONNREJ (Object) => TAE_CONNREJ
AE_CONNSTART (Object) => TAE_CONNSTART
AE_CONNSTOP (Object) => TAE_CONNSTOP
AE_LOCKOUT (Object) => TAE_LOCKOUT
AE_NETLOGOFF (Object) => TAE_NETLOGOFF
AE_NETLOGON (Object) => TAE_NETLOGON
AE_RESACCESS (Object) => TAE_RESACCESS
AE_RESACCESSREJ (Object) => TAE_RESACCESSREJ
AE_SERVICESTAT (Object) => TAE_SERVICESTAT
AE_SESSLOGOFF (Object) => TAE_SESSLOGOFF
AE_SESSLOGON (Object) => TAE_SESSLOGON
AE_SESSPWERR (Object) => TAE_SESSPWERR
AE_SRVSTATUS (Object) => TAE_SRVSTATUS
AE_UASMOD (Object) => TAE_UASMOD
Algid (AccessProc) => algid
AllElements (Const) => allElements
ApplyLowPowerScenarioSettings (Const) => applyLowPowerScenarioSettings
ASN_APPLICATION (Const) => asnAPPLICATION
ASN_BITS (Const) => asnBITS
ASN_CONSTRUCTOR (Const) => asnCONSTRUCTOR
ASN_CONTEXT (Const) => asnCONTEXT
ASN_CONTEXTSPECIFIC (Const) => asnCONTEXTSPECIFIC
ASN_COUNTER32 (Const) => asnCOUNTER32
ASN_COUNTER64 (Const) => asnCOUNTER64
ASN_GAUGE32 (Const) => asnGAUGE32
ASN_INTEGER (Const) => asnINTEGER
ASN_INTEGER32 (Const) => asnINTEGER32
ASN_IPADDRESS (Const) => asnIPADDRESS
ASN_NULL (Const) => asnNULL
ASN_OBJECTIDENTIFIER (Const) => asnOBJECTIDENTIFIER
ASN_OCTETSTRING (Const) => asnOCTETSTRING
ASN_OPAQUE (Const) => asnOPAQUE
ASN_PRIMATIVE (Const) => asnPRIMATIVE
ASN_PRIMITIVE (Const) => asnPRIMITIVE
ASN_PRIVATE (Const) => asnPRIVATE
ASN_RFC1155_COUNTER (Const) => asnRFC1155_COUNTER
ASN_RFC1155_GAUGE (Const) => asnRFC1155_GAUGE
ASN_RFC1155_IPADDRESS (Const) => asnRFC1155_IPADDRESS
ASN_RFC1155_OPAQUE (Const) => asnRFC1155_OPAQUE
ASN_RFC1155_TIMETICKS (Const) => asnRFC1155_TIMETICKS
ASN_RFC1157_GETNEXTREQUEST (Const) => asnRFC1157_GETNEXTREQUEST
ASN_RFC1157_GETREQUEST (Const) => asnRFC1157_GETREQUEST
ASN_RFC1157_GETRESPONSE (Const) => asnRFC1157_GETRESPONSE
ASN_RFC1157_SETREQUEST (Const) => asnRFC1157_SETREQUEST
ASN_RFC1157_TRAP (Const) => asnRFC1157_TRAP
ASN_RFC1213_DISPSTRING (Const) => asnRFC1213_DISPSTRING
ASN_RFC2578_UNSIGNED32 (Const) => asnRFC2578_UNSIGNED32
ASN_SEQUENCE (Const) => asnSEQUENCE
ASN_SEQUENCEOF (Const) => asnSEQUENCEOF
ASN_TIMETICKS (Const) => asnTIMETICKS
ASN_UINTEGER32 (Const) => asnUINTEGER32
ASN_UNIVERSAL (Const) => asnUNIVERSAL
ASN_UNSIGNED32 (Const) => asnUNSIGNED32
AssemblyDetailedInformationInActivationContext (Const) => assemblyDetailedInformationInActivationContext
AssemblyDetailedInformationInActivationContxt (Const) => assemblyDetailedInformationInActivationContxt
Assertive (Const) => assertive
AuditCategoryAccountLogon (Const) => auditCategoryAccountLogon
AuditCategoryAccountManagement (Const) => auditCategoryAccountManagement
AuditCategoryDetailedTracking (Const) => auditCategoryDetailedTracking
AuditCategoryDirectoryServiceAccess (Const) => auditCategoryDirectoryServiceAccess
AuditCategoryLogon (Const) => auditCategoryLogon
AuditCategoryObjectAccess (Const) => auditCategoryObjectAccess
AuditCategoryPolicyChange (Const) => auditCategoryPolicyChange
AuditCategoryPrivilegeUse (Const) => auditCategoryPrivilegeUse
AuditCategorySystem (Const) => auditCategorySystem
AuditEventDirectoryServiceAccess (Const) => auditEventDirectoryServiceAccess
AuditEventObjectAccess (Const) => auditEventObjectAccess
AuthzAuditEventInfoAdditionalInfo (Const) => authzAuditEventInfoAdditionalInfo
AuthzAuditEventInfoFlags (Const) => authzAuditEventInfoFlags
AuthzAuditEventInfoObjectName (Const) => authzAuditEventInfoObjectName
AuthzAuditEventInfoObjectType (Const) => authzAuditEventInfoObjectType
AuthzAuditEventInfoOperationType (Const) => authzAuditEventInfoOperationType
AuthzContextInfoAll (Const) => authzContextInfoAll
AuthzContextInfoAppContainerSid (Const) => authzContextInfoAppContainerSid
AuthzContextInfoAuthenticationId (Const) => authzContextInfoAuthenticationId
AuthzContextInfoCapabilitySids (Const) => authzContextInfoCapabilitySids
AuthzContextInfoDeviceClaims (Const) => authzContextInfoDeviceClaims
AuthzContextInfoDeviceSids (Const) => authzContextInfoDeviceSids
AuthzContextInfoExpirationTime (Const) => authzContextInfoExpirationTime
AuthzContextInfoGroupsSids (Const) => authzContextInfoGroupsSids
AuthzContextInfoIdentifier (Const) => authzContextInfoIdentifier
AuthzContextInfoPrivileges (Const) => authzContextInfoPrivileges
AuthzContextInfoRestrictedSids (Const) => authzContextInfoRestrictedSids
AuthzContextInfoSecurityAttributes (Const) => authzContextInfoSecurityAttributes
AuthzContextInfoServerContext (Const) => authzContextInfoServerContext
AuthzContextInfoSource (Const) => authzContextInfoSource
AuthzContextInfoUserClaims (Const) => authzContextInfoUserClaims
AuthzContextInfoUserSid (Const) => authzContextInfoUserSid
AutoLoad (Const) => autoLoad
AVIFILEINFO (Type) => TAVIFILEINFO
AVIFILEINFOA (Object) => TAVIFILEINFOA
AVIFILEINFOW (Object) => TAVIFILEINFOW
AVISTREAMINFO (Type) => TAVISTREAMINFO
AVISTREAMINFOA (Object) => TAVISTREAMINFOA
AVISTREAMINFOW (Object) => TAVISTREAMINFOW
Batch (Const) => batch
BEGIN_PATH (Const) => beginPath
beginPath (Method) => mBeginPath
bind (Api) => `bind`
BindExpandFileHeaders (Const) => bindExpandFileHeaders
BindForwarder (Const) => bindForwarder
BindForwarder32 (Const) => bindForwarder32
BindForwarder64 (Const) => bindForwarder64
BindForwarderNOT (Const) => bindForwarderNOT
BindForwarderNOT32 (Const) => bindForwarderNOT32
BindForwarderNOT64 (Const) => bindForwarderNOT64
BindImageComplete (Const) => bindImageComplete
BindImageModified (Const) => bindImageModified
BindImportModule (Const) => bindImportModule
BindImportModuleFailed (Const) => bindImportModuleFailed
BindImportProcedure (Const) => bindImportProcedure
BindImportProcedure32 (Const) => bindImportProcedure32
BindImportProcedure64 (Const) => bindImportProcedure64
BindImportProcedureFailed (Const) => bindImportProcedureFailed
BindMismatchedSymbols (Const) => bindMismatchedSymbols
BindNoRoomInImage (Const) => bindNoRoomInImage
BindOutOfMemory (Const) => bindOutOfMemory
BindRvaToVaFailed (Const) => bindRvaToVaFailed
BindSymbolsNotUpdated (Const) => bindSymbolsNotUpdated
BootLoad (Const) => bootLoad
BrushType (Type) => GpBrushType
BrushTypeHatchFill (Const) => brushTypeHatchFill
BrushTypeLinearGradient (Const) => brushTypeLinearGradient
BrushTypePathGradient (Const) => brushTypePathGradient
BrushTypeSolidColor (Const) => brushTypeSolidColor
BrushTypeTextureFill (Const) => brushTypeTextureFill
BucketParamLength (Const) => bucketParamLength
BucketParamsCount (Const) => bucketParamsCount
BusType1394 (Const) => busType1394
BusTypeAta (Const) => busTypeAta
BusTypeAtapi (Const) => busTypeAtapi
BusTypeFibre (Const) => busTypeFibre
BusTypeFileBackedVirtual (Const) => busTypeFileBackedVirtual
BusTypeiScsi (Const) => busTypeiScsi
BusTypeMax (Const) => busTypeMax
BusTypeMaxReserved (Const) => busTypeMaxReserved
BusTypeMmc (Const) => busTypeMmc
BusTypeRAID (Const) => busTypeRAID
BusTypeSas (Const) => busTypeSas
BusTypeSata (Const) => busTypeSata
BusTypeScsi (Const) => busTypeScsi
BusTypeSd (Const) => busTypeSd
BusTypeSsa (Const) => busTypeSsa
BusTypeUnknown (Const) => busTypeUnknown
BusTypeUsb (Const) => busTypeUsb
BusTypeVirtual (Const) => busTypeVirtual
CacheData (Const) => cacheData
CachedInteractive (Const) => cachedInteractive
CachedRemoteInteractive (Const) => cachedRemoteInteractive
CachedUnlock (Const) => cachedUnlock
CacheInstruction (Const) => cacheInstruction
CacheRangeChunkSize (Const) => cacheRangeChunkSize
CacheTrace (Const) => cacheTrace
CacheUnified (Const) => cacheUnified
CancelCallback (Const) => cancelCallback
CATEGORY_INFO (Object) => TCATEGORY_INFO
CdChangerClassGuid (Const) => cdChangerClassGuid
CdRomClassGuid (Const) => cdRomClassGuid
CertCredential (Const) => certCredential
ChangerDoor (Const) => changerDoor
ChangerDrive (Const) => changerDrive
ChangerIEPort (Const) => changerIEPort
ChangerKeypad (Const) => changerKeypad
ChangerMaxElement (Const) => changerMaxElement
ChangerSlot (Const) => changerSlot
ChangerTransport (Const) => changerTransport
CHOOSECOLOR (Type) => TCHOOSECOLOR
CHOOSECOLORA (Object) => TCHOOSECOLORA
CHOOSECOLORW (Object) => TCHOOSECOLORW
CHOOSEFONT (Type) => TCHOOSEFONT
CHOOSEFONTA (Object) => TCHOOSEFONTA
CHOOSEFONTW (Object) => TCHOOSEFONTW
CollisionOther (Const) => collisionOther
CollisionTdo (Const) => collisionTdo
CollisionXref (Const) => collisionXref
ColorAdjustTypeAny (Const) => colorAdjustTypeAny
ColorAdjustTypeBitmap (Const) => colorAdjustTypeBitmap
ColorAdjustTypeBrush (Const) => colorAdjustTypeBrush
ColorAdjustTypeCount (Const) => colorAdjustTypeCount
ColorAdjustTypeDefault (Const) => colorAdjustTypeDefault
ColorAdjustTypePen (Const) => colorAdjustTypePen
ColorAdjustTypeText (Const) => colorAdjustTypeText
ColorChannelFlagsC (Const) => colorChannelFlagsC
ColorChannelFlagsK (Const) => colorChannelFlagsK
ColorChannelFlagsLast (Const) => colorChannelFlagsLast
ColorChannelFlagsM (Const) => colorChannelFlagsM
ColorChannelFlagsY (Const) => colorChannelFlagsY
ColorMap (Object) => GpColorMap
ColorMatrixFlagsAltGray (Const) => colorMatrixFlagsAltGray
ColorMatrixFlagsDefault (Const) => colorMatrixFlagsDefault
ColorMatrixFlagsSkipGrays (Const) => colorMatrixFlagsSkipGrays
CombineModeComplement (Const) => combineModeComplement
CombineModeExclude (Const) => combineModeExclude
CombineModeIntersect (Const) => combineModeIntersect
CombineModeReplace (Const) => combineModeReplace
CombineModeUnion (Const) => combineModeUnion
CombineModeXor (Const) => combineModeXor
CommentStreamA (Const) => commentStreamA
CommentStreamW (Const) => commentStreamW
COMPARE_STRING (Const) => compareString
CompatibilityInformationInActivationContext (Const) => compatibilityInformationInActivationContext
ComponentTypeEnforcementClientRp (Const) => componentTypeEnforcementClientRp
ComponentTypeEnforcementClientSoH (Const) => componentTypeEnforcementClientSoH
CompositingModeSourceCopy (Const) => compositingModeSourceCopy
CompositingModeSourceOver (Const) => compositingModeSourceOver
CompositingQualityAssumeLinear (Const) => compositingQualityAssumeLinear
CompositingQualityDefault (Const) => compositingQualityDefault
CompositingQualityGammaCorrected (Const) => compositingQualityGammaCorrected
CompositingQualityHighQuality (Const) => compositingQualityHighQuality
CompositingQualityHighSpeed (Const) => compositingQualityHighSpeed
ComputerNameDnsDomain (Const) => computerNameDnsDomain
ComputerNameDnsFullyQualified (Const) => computerNameDnsFullyQualified
ComputerNameDnsHostname (Const) => computerNameDnsHostname
ComputerNameMax (Const) => computerNameMax
ComputerNameNetBIOS (Const) => computerNameNetBIOS
ComputerNamePhysicalDnsDomain (Const) => computerNamePhysicalDnsDomain
ComputerNamePhysicalDnsFullyQualified (Const) => computerNamePhysicalDnsFullyQualified
ComputerNamePhysicalDnsHostname (Const) => computerNamePhysicalDnsHostname
ComputerNamePhysicalNetBIOS (Const) => computerNamePhysicalNetBIOS
CoordinateSpace (Type) => GpCoordinateSpace
CoordinateSpaceDevice (Const) => coordinateSpaceDevice
CoordinateSpacePage (Const) => coordinateSpacePage
CoordinateSpaceWorld (Const) => coordinateSpaceWorld
CredTrustedProtection (Const) => credTrustedProtection
CredUnprotected (Const) => credUnprotected
CredUserProtection (Const) => credUserProtection
CriticalError (Const) => criticalError
CRYPT_DECRYPT (Const) => crypt_decrypt
CRYPT_DESTROYKEY (Const) => crypt_destroykey
CRYPT_ENCRYPT (Const) => crypt_encrypt
CRYPT_EXPORT_KEY (Const) => crypt_export_key
CRYPT_IMPORT_KEY (Const) => crypt_import_key
CsDeviceNotification (Const) => csDeviceNotification
CurveChannelAll (Const) => curveChannelAll
CurveChannelBlue (Const) => curveChannelBlue
CurveChannelGreen (Const) => curveChannelGreen
CurveChannelRed (Const) => curveChannelRed
CustomLineCapTypeAdjustableArrow (Const) => customLineCapTypeAdjustableArrow
CustomLineCapTypeDefault (Const) => customLineCapTypeDefault
DashCap (Type) => GpDashCap
DashCapFlat (Const) => dashCapFlat
DashCapRound (Const) => dashCapRound
DashCapTriangle (Const) => dashCapTriangle
DashStyle (Type) => GpDashStyle
DashStyleCustom (Const) => dashStyleCustom
DashStyleDash (Const) => dashStyleDash
DashStyleDashDot (Const) => dashStyleDashDot
DashStyleDashDotDot (Const) => dashStyleDashDotDot
DashStyleDot (Const) => dashStyleDot
DashStyleSolid (Const) => dashStyleSolid
DelayExecution (Const) => delayExecution
Delete (Method) => mDelete
DemandLoad (Const) => demandLoad
DEPPolicyAlwaysOff (Const) => dEPPolicyAlwaysOff
DEPPolicyAlwaysOn (Const) => dEPPolicyAlwaysOn
DEPPolicyOptIn (Const) => dEPPolicyOptIn
DEPPolicyOptOut (Const) => dEPPolicyOptOut
DEPTotalPolicyCount (Const) => dEPTotalPolicyCount
DetectExInt13 (Const) => detectExInt13
DetectInt13 (Const) => detectInt13
DetectNone (Const) => detectNone
DeviceProblemCalibrationError (Const) => deviceProblemCalibrationError
DeviceProblemCartridgeEjectError (Const) => deviceProblemCartridgeEjectError
DeviceProblemCartridgeInsertError (Const) => deviceProblemCartridgeInsertError
DeviceProblemCHMError (Const) => deviceProblemCHMError
DeviceProblemCHMMoveError (Const) => deviceProblemCHMMoveError
DeviceProblemCHMZeroError (Const) => deviceProblemCHMZeroError
DeviceProblemDoorOpen (Const) => deviceProblemDoorOpen
DeviceProblemDriveError (Const) => deviceProblemDriveError
DeviceProblemGripperError (Const) => deviceProblemGripperError
DeviceProblemHardware (Const) => deviceProblemHardware
DeviceProblemNone (Const) => deviceProblemNone
DeviceProblemPositionError (Const) => deviceProblemPositionError
DeviceProblemSensorError (Const) => deviceProblemSensorError
DeviceProblemTargetFailure (Const) => deviceProblemTargetFailure
DfsGlobalHighPriorityClass (Const) => dfsGlobalHighPriorityClass
DfsGlobalLowPriorityClass (Const) => dfsGlobalLowPriorityClass
DfsInvalidPriorityClass (Const) => dfsInvalidPriorityClass
DfsSiteCostHighPriorityClass (Const) => dfsSiteCostHighPriorityClass
DfsSiteCostLowPriorityClass (Const) => dfsSiteCostLowPriorityClass
DfsSiteCostNormalPriorityClass (Const) => dfsSiteCostNormalPriorityClass
DIID__SearchAssistantEvents (Const) => DIID_SearchAssistantEvents
DisableLoad (Const) => disableLoad
DiskClassGuid (Const) => diskClassGuid
DisplayBurst (Const) => displayBurst
DitherTypeDualSpiral4x4 (Const) => ditherTypeDualSpiral4x4
DitherTypeDualSpiral8x8 (Const) => ditherTypeDualSpiral8x8
DitherTypeErrorDiffusion (Const) => ditherTypeErrorDiffusion
DitherTypeNone (Const) => ditherTypeNone
DitherTypeOrdered16x16 (Const) => ditherTypeOrdered16x16
DitherTypeOrdered4x4 (Const) => ditherTypeOrdered4x4
DitherTypeOrdered8x8 (Const) => ditherTypeOrdered8x8
DitherTypeOrdered91x91 (Const) => ditherTypeOrdered91x91
DitherTypeSolid (Const) => ditherTypeSolid
DitherTypeSpiral4x4 (Const) => ditherTypeSpiral4x4
DitherTypeSpiral8x8 (Const) => ditherTypeSpiral8x8
DnsCharSetAnsi (Const) => dnsCharSetAnsi
DnsCharSetUnicode (Const) => dnsCharSetUnicode
DnsCharSetUnknown (Const) => dnsCharSetUnknown
DnsCharSetUtf8 (Const) => dnsCharSetUtf8
DnsConfigAdapterHostNameRegistrationEnabled (Const) => dnsConfigAdapterHostNameRegistrationEnabled
DnsConfigAdapterInfo (Const) => dnsConfigAdapterInfo
DnsConfigAddressRegistrationMaxCount (Const) => dnsConfigAddressRegistrationMaxCount
DnsConfigDnsServerList (Const) => dnsConfigDnsServerList
DnsConfigPrimaryHostNameRegistrationEnabled (Const) => dnsConfigPrimaryHostNameRegistrationEnabled
DnsConfigSearchList (Const) => dnsConfigSearchList
DnsFreeFlat (Const) => dnsFreeFlat
DnsFreeParsedMessageFields (Const) => dnsFreeParsedMessageFields
DnsFreeRecordList (Const) => dnsFreeRecordList
DnsFreeRecordListDeep (Const) => dnsFreeRecordListDeep
DnsNameDomain (Const) => dnsNameDomain
DnsNameDomainLabel (Const) => dnsNameDomainLabel
DnsNameHostnameFull (Const) => dnsNameHostnameFull
DnsNameHostnameLabel (Const) => dnsNameHostnameLabel
DnsNameSrvRecord (Const) => dnsNameSrvRecord
DnsNameWildcard (Const) => dnsNameWildcard
DnsSectionAddtional (Const) => dnsSectionAddtional
DnsSectionAnswer (Const) => dnsSectionAnswer
DnsSectionAuthority (Const) => dnsSectionAuthority
DnsSectionPrereq (Const) => dnsSectionPrereq
DnsSectionQuestion (Const) => dnsSectionQuestion
DnsSectionUpdate (Const) => dnsSectionUpdate
DnsSectionZone (Const) => dnsSectionZone
DomConstructorAttr (Const) => domConstructorAttr
DomConstructorBehaviorUrnsCollection (Const) => domConstructorBehaviorUrnsCollection
DomConstructorBookmarkCollection (Const) => domConstructorBookmarkCollection
DomConstructorCompatibleInfo (Const) => domConstructorCompatibleInfo
DomConstructorCompatibleInfoCollection (Const) => domConstructorCompatibleInfoCollection
DomConstructorControlRangeCollection (Const) => domConstructorControlRangeCollection
DomConstructorCSSCurrentStyleDeclaration (Const) => domConstructorCSSCurrentStyleDeclaration
DomConstructorCSSRuleList (Const) => domConstructorCSSRuleList
DomConstructorCSSRuleStyleDeclaration (Const) => domConstructorCSSRuleStyleDeclaration
DomConstructorCSSStyleDeclaration (Const) => domConstructorCSSStyleDeclaration
DomConstructorCSSStyleRule (Const) => domConstructorCSSStyleRule
DomConstructorCSSStyleSheet (Const) => domConstructorCSSStyleSheet
DomConstructorDataTransfer (Const) => domConstructorDataTransfer
DomConstructorDOMImplementation (Const) => domConstructorDOMImplementation
DomConstructorElement (Const) => domConstructorElement
DomConstructorEvent (Const) => domConstructorEvent
DomConstructorHistory (Const) => domConstructorHistory
DomConstructorHTCElementBehaviorDefaults (Const) => domConstructorHTCElementBehaviorDefaults
DomConstructorHTMLAnchorElement (Const) => domConstructorHTMLAnchorElement
DomConstructorHTMLAreaElement (Const) => domConstructorHTMLAreaElement
DomConstructorHTMLAreasCollection (Const) => domConstructorHTMLAreasCollection
DomConstructorHTMLBaseElement (Const) => domConstructorHTMLBaseElement
DomConstructorHTMLBaseFontElement (Const) => domConstructorHTMLBaseFontElement
DomConstructorHTMLBGSoundElement (Const) => domConstructorHTMLBGSoundElement
DomConstructorHTMLBlockElement (Const) => domConstructorHTMLBlockElement
DomConstructorHTMLBodyElement (Const) => domConstructorHTMLBodyElement
DomConstructorHTMLBRElement (Const) => domConstructorHTMLBRElement
DomConstructorHTMLButtonElement (Const) => domConstructorHTMLButtonElement
DomConstructorHTMLCollection (Const) => domConstructorHTMLCollection
DomConstructorHTMLCommentElement (Const) => domConstructorHTMLCommentElement
DomConstructorHTMLDDElement (Const) => domConstructorHTMLDDElement
DomConstructorHTMLDivElement (Const) => domConstructorHTMLDivElement
DomConstructorHTMLDListElement (Const) => domConstructorHTMLDListElement
DomConstructorHTMLDocument (Const) => domConstructorHTMLDocument
DomConstructorHTMLDTElement (Const) => domConstructorHTMLDTElement
DomConstructorHTMLEmbedElement (Const) => domConstructorHTMLEmbedElement
DomConstructorHTMLFieldSetElement (Const) => domConstructorHTMLFieldSetElement
DomConstructorHTMLFontElement (Const) => domConstructorHTMLFontElement
DomConstructorHTMLFormElement (Const) => domConstructorHTMLFormElement
DomConstructorHTMLFrameElement (Const) => domConstructorHTMLFrameElement
DomConstructorHTMLFrameSetElement (Const) => domConstructorHTMLFrameSetElement
DomConstructorHTMLGenericElement (Const) => domConstructorHTMLGenericElement
DomConstructorHTMLHeadElement (Const) => domConstructorHTMLHeadElement
DomConstructorHTMLHeadingElement (Const) => domConstructorHTMLHeadingElement
DomConstructorHTMLHRElement (Const) => domConstructorHTMLHRElement
DomConstructorHTMLHtmlElement (Const) => domConstructorHTMLHtmlElement
DomConstructorHTMLIFrameElement (Const) => domConstructorHTMLIFrameElement
DomConstructorHTMLImageElement (Const) => domConstructorHTMLImageElement
DomConstructorHTMLInputElement (Const) => domConstructorHTMLInputElement
DomConstructorHTMLIsIndexElement (Const) => domConstructorHTMLIsIndexElement
DomConstructorHTMLLabelElement (Const) => domConstructorHTMLLabelElement
DomConstructorHTMLLegendElement (Const) => domConstructorHTMLLegendElement
DomConstructorHTMLLIElement (Const) => domConstructorHTMLLIElement
DomConstructorHTMLLinkElement (Const) => domConstructorHTMLLinkElement
DomConstructorHTMLMapElement (Const) => domConstructorHTMLMapElement
DomConstructorHTMLMarqueeElement (Const) => domConstructorHTMLMarqueeElement
DomConstructorHTMLMetaElement (Const) => domConstructorHTMLMetaElement
DomConstructorHTMLModelessDialog (Const) => domConstructorHTMLModelessDialog
DomConstructorHTMLNamespaceInfo (Const) => domConstructorHTMLNamespaceInfo
DomConstructorHTMLNamespaceInfoCollection (Const) => domConstructorHTMLNamespaceInfoCollection
DomConstructorHTMLNextIdElement (Const) => domConstructorHTMLNextIdElement
DomConstructorHTMLNoShowElement (Const) => domConstructorHTMLNoShowElement
DomConstructorHTMLObjectElement (Const) => domConstructorHTMLObjectElement
DomConstructorHTMLOListElement (Const) => domConstructorHTMLOListElement
DomConstructorHTMLOptionElement (Const) => domConstructorHTMLOptionElement
DomConstructorHTMLParagraphElement (Const) => domConstructorHTMLParagraphElement
DomConstructorHTMLParamElement (Const) => domConstructorHTMLParamElement
DomConstructorHTMLPhraseElement (Const) => domConstructorHTMLPhraseElement
DomConstructorHTMLPluginsCollection (Const) => domConstructorHTMLPluginsCollection
DomConstructorHTMLPopup (Const) => domConstructorHTMLPopup
DomConstructorHTMLScriptElement (Const) => domConstructorHTMLScriptElement
DomConstructorHTMLSelectElement (Const) => domConstructorHTMLSelectElement
DomConstructorHTMLSpanElement (Const) => domConstructorHTMLSpanElement
DomConstructorHTMLStyleElement (Const) => domConstructorHTMLStyleElement
DomConstructorHTMLTableCaptionElement (Const) => domConstructorHTMLTableCaptionElement
DomConstructorHTMLTableCellElement (Const) => domConstructorHTMLTableCellElement
DomConstructorHTMLTableColElement (Const) => domConstructorHTMLTableColElement
DomConstructorHTMLTableElement (Const) => domConstructorHTMLTableElement
DomConstructorHTMLTableRowElement (Const) => domConstructorHTMLTableRowElement
DomConstructorHTMLTableSectionElement (Const) => domConstructorHTMLTableSectionElement
DomConstructorHTMLTextAreaElement (Const) => domConstructorHTMLTextAreaElement
DomConstructorHTMLTextElement (Const) => domConstructorHTMLTextElement
DomConstructorHTMLTitleElement (Const) => domConstructorHTMLTitleElement
DomConstructorHTMLUListElement (Const) => domConstructorHTMLUListElement
DomConstructorHTMLUnknownElement (Const) => domConstructorHTMLUnknownElement
DomConstructorImage (Const) => domConstructorImage
DomConstructorLocation (Const) => domConstructorLocation
DomConstructorMax (Const) => domConstructorMax
DomConstructorNamedNodeMap (Const) => domConstructorNamedNodeMap
DomConstructorNavigator (Const) => domConstructorNavigator
DomConstructorNodeList (Const) => domConstructorNodeList
DomConstructorObject (Const) => domConstructorObject
DomConstructorOption (Const) => domConstructorOption
DomConstructorScreen (Const) => domConstructorScreen
DomConstructorSelection (Const) => domConstructorSelection
DomConstructorStaticNodeList (Const) => domConstructorStaticNodeList
DomConstructorStorage (Const) => domConstructorStorage
DomConstructorStyleSheetList (Const) => domConstructorStyleSheetList
DomConstructorStyleSheetPage (Const) => domConstructorStyleSheetPage
DomConstructorStyleSheetPageList (Const) => domConstructorStyleSheetPageList
DomConstructorText (Const) => domConstructorText
DomConstructorTextRange (Const) => domConstructorTextRange
DomConstructorTextRangeCollection (Const) => domConstructorTextRangeCollection
DomConstructorTextRectangle (Const) => domConstructorTextRectangle
DomConstructorTextRectangleList (Const) => domConstructorTextRectangleList
DomConstructorWindow (Const) => domConstructorWindow
DomConstructorXDomainRequest (Const) => domConstructorXDomainRequest
DomConstructorXMLHttpRequest (Const) => domConstructorXMLHttpRequest
DRAWDIBTIME (Object) => TDRAWDIBTIME
DriverStringOptionsCmapLookup (Const) => driverStringOptionsCmapLookup
DriverStringOptionsLimitSubpixel (Const) => driverStringOptionsLimitSubpixel
DriverStringOptionsRealizedAdvance (Const) => driverStringOptionsRealizedAdvance
DriverStringOptionsVertical (Const) => driverStringOptionsVertical
DriverType (Const) => driverType
DWM_SHOWCONTACT (Type) => DWM_SHOWCONTACT_ENUM
EEInfoGCCOM (Const) => eEInfoGCCOM
EEInfoGCFRS (Const) => eEInfoGCFRS
EEInfoNextRecordsMissing (Const) => eEInfoNextRecordsMissing
EEInfoPreviousRecordsMissing (Const) => eEInfoPreviousRecordsMissing
EEInfoUseFileTime (Const) => eEInfoUseFileTime
EmfPlusRecordTotal (Const) => emfPlusRecordTotal
EmfPlusRecordTypeBeginContainer (Const) => emfPlusRecordTypeBeginContainer
EmfPlusRecordTypeBeginContainerNoParams (Const) => emfPlusRecordTypeBeginContainerNoParams
EmfPlusRecordTypeClear (Const) => emfPlusRecordTypeClear
EmfPlusRecordTypeComment (Const) => emfPlusRecordTypeComment
EmfPlusRecordTypeDrawArc (Const) => emfPlusRecordTypeDrawArc
EmfPlusRecordTypeDrawBeziers (Const) => emfPlusRecordTypeDrawBeziers
EmfPlusRecordTypeDrawClosedCurve (Const) => emfPlusRecordTypeDrawClosedCurve
EmfPlusRecordTypeDrawCurve (Const) => emfPlusRecordTypeDrawCurve
EmfPlusRecordTypeDrawDriverString (Const) => emfPlusRecordTypeDrawDriverString
EmfPlusRecordTypeDrawEllipse (Const) => emfPlusRecordTypeDrawEllipse
EmfPlusRecordTypeDrawImage (Const) => emfPlusRecordTypeDrawImage
EmfPlusRecordTypeDrawImagePoints (Const) => emfPlusRecordTypeDrawImagePoints
EmfPlusRecordTypeDrawLines (Const) => emfPlusRecordTypeDrawLines
EmfPlusRecordTypeDrawPath (Const) => emfPlusRecordTypeDrawPath
EmfPlusRecordTypeDrawPie (Const) => emfPlusRecordTypeDrawPie
EmfPlusRecordTypeDrawRects (Const) => emfPlusRecordTypeDrawRects
EmfPlusRecordTypeDrawString (Const) => emfPlusRecordTypeDrawString
EmfPlusRecordTypeEndContainer (Const) => emfPlusRecordTypeEndContainer
EmfPlusRecordTypeEndOfFile (Const) => emfPlusRecordTypeEndOfFile
EmfPlusRecordTypeFillClosedCurve (Const) => emfPlusRecordTypeFillClosedCurve
EmfPlusRecordTypeFillEllipse (Const) => emfPlusRecordTypeFillEllipse
EmfPlusRecordTypeFillPath (Const) => emfPlusRecordTypeFillPath
EmfPlusRecordTypeFillPie (Const) => emfPlusRecordTypeFillPie
EmfPlusRecordTypeFillPolygon (Const) => emfPlusRecordTypeFillPolygon
EmfPlusRecordTypeFillRects (Const) => emfPlusRecordTypeFillRects
EmfPlusRecordTypeFillRegion (Const) => emfPlusRecordTypeFillRegion
EmfPlusRecordTypeGetDC (Const) => emfPlusRecordTypeGetDC
EmfPlusRecordTypeHeader (Const) => emfPlusRecordTypeHeader
EmfPlusRecordTypeInvalid (Const) => emfPlusRecordTypeInvalid
EmfPlusRecordTypeMax (Const) => emfPlusRecordTypeMax
EmfPlusRecordTypeMin (Const) => emfPlusRecordTypeMin
EmfPlusRecordTypeMultiFormatEnd (Const) => emfPlusRecordTypeMultiFormatEnd
EmfPlusRecordTypeMultiFormatSection (Const) => emfPlusRecordTypeMultiFormatSection
EmfPlusRecordTypeMultiFormatStart (Const) => emfPlusRecordTypeMultiFormatStart
EmfPlusRecordTypeMultiplyWorldTransform (Const) => emfPlusRecordTypeMultiplyWorldTransform
EmfPlusRecordTypeObject (Const) => emfPlusRecordTypeObject
EmfPlusRecordTypeOffsetClip (Const) => emfPlusRecordTypeOffsetClip
EmfPlusRecordTypeResetClip (Const) => emfPlusRecordTypeResetClip
EmfPlusRecordTypeResetWorldTransform (Const) => emfPlusRecordTypeResetWorldTransform
EmfPlusRecordTypeRestore (Const) => emfPlusRecordTypeRestore
EmfPlusRecordTypeRotateWorldTransform (Const) => emfPlusRecordTypeRotateWorldTransform
EmfPlusRecordTypeSave (Const) => emfPlusRecordTypeSave
EmfPlusRecordTypeScaleWorldTransform (Const) => emfPlusRecordTypeScaleWorldTransform
EmfPlusRecordTypeSerializableObject (Const) => emfPlusRecordTypeSerializableObject
EmfPlusRecordTypeSetAntiAliasMode (Const) => emfPlusRecordTypeSetAntiAliasMode
EmfPlusRecordTypeSetClipPath (Const) => emfPlusRecordTypeSetClipPath
EmfPlusRecordTypeSetClipRect (Const) => emfPlusRecordTypeSetClipRect
EmfPlusRecordTypeSetClipRegion (Const) => emfPlusRecordTypeSetClipRegion
EmfPlusRecordTypeSetCompositingMode (Const) => emfPlusRecordTypeSetCompositingMode
EmfPlusRecordTypeSetCompositingQuality (Const) => emfPlusRecordTypeSetCompositingQuality
EmfPlusRecordTypeSetGammaValue (Const) => emfPlusRecordTypeSetGammaValue
EmfPlusRecordTypeSetInterpolationMode (Const) => emfPlusRecordTypeSetInterpolationMode
EmfPlusRecordTypeSetPageTransform (Const) => emfPlusRecordTypeSetPageTransform
EmfPlusRecordTypeSetPixelOffsetMode (Const) => emfPlusRecordTypeSetPixelOffsetMode
EmfPlusRecordTypeSetRenderingOrigin (Const) => emfPlusRecordTypeSetRenderingOrigin
EmfPlusRecordTypeSetTextContrast (Const) => emfPlusRecordTypeSetTextContrast
EmfPlusRecordTypeSetTextRenderingHint (Const) => emfPlusRecordTypeSetTextRenderingHint
EmfPlusRecordTypeSetTSClip (Const) => emfPlusRecordTypeSetTSClip
EmfPlusRecordTypeSetTSGraphics (Const) => emfPlusRecordTypeSetTSGraphics
EmfPlusRecordTypeSetWorldTransform (Const) => emfPlusRecordTypeSetWorldTransform
EmfPlusRecordTypeStrokeFillPath (Const) => emfPlusRecordTypeStrokeFillPath
EmfPlusRecordTypeTranslateWorldTransform (Const) => emfPlusRecordTypeTranslateWorldTransform
EmfRecordTypeAbortPath (Const) => emfRecordTypeAbortPath
EmfRecordTypeAlphaBlend (Const) => emfRecordTypeAlphaBlend
EmfRecordTypeAngleArc (Const) => emfRecordTypeAngleArc
EmfRecordTypeArc (Const) => emfRecordTypeArc
EmfRecordTypeArcTo (Const) => emfRecordTypeArcTo
EmfRecordTypeBeginPath (Const) => emfRecordTypeBeginPath
EmfRecordTypeBitBlt (Const) => emfRecordTypeBitBlt
EmfRecordTypeChord (Const) => emfRecordTypeChord
EmfRecordTypeCloseFigure (Const) => emfRecordTypeCloseFigure
EmfRecordTypeColorCorrectPalette (Const) => emfRecordTypeColorCorrectPalette
EmfRecordTypeColorMatchToTargetW (Const) => emfRecordTypeColorMatchToTargetW
EmfRecordTypeCreateBrushIndirect (Const) => emfRecordTypeCreateBrushIndirect
EmfRecordTypeCreateColorSpace (Const) => emfRecordTypeCreateColorSpace
EmfRecordTypeCreateColorSpaceW (Const) => emfRecordTypeCreateColorSpaceW
EmfRecordTypeCreateDIBPatternBrushPt (Const) => emfRecordTypeCreateDIBPatternBrushPt
EmfRecordTypeCreateMonoBrush (Const) => emfRecordTypeCreateMonoBrush
EmfRecordTypeCreatePalette (Const) => emfRecordTypeCreatePalette
EmfRecordTypeCreatePen (Const) => emfRecordTypeCreatePen
EmfRecordTypeDeleteColorSpace (Const) => emfRecordTypeDeleteColorSpace
EmfRecordTypeDeleteObject (Const) => emfRecordTypeDeleteObject
EmfRecordTypeDrawEscape (Const) => emfRecordTypeDrawEscape
EmfRecordTypeEllipse (Const) => emfRecordTypeEllipse
EmfRecordTypeEndPath (Const) => emfRecordTypeEndPath
EmfRecordTypeEOF (Const) => emfRecordTypeEOF
EmfRecordTypeExcludeClipRect (Const) => emfRecordTypeExcludeClipRect
EmfRecordTypeExtCreateFontIndirect (Const) => emfRecordTypeExtCreateFontIndirect
EmfRecordTypeExtCreatePen (Const) => emfRecordTypeExtCreatePen
EmfRecordTypeExtEscape (Const) => emfRecordTypeExtEscape
EmfRecordTypeExtFloodFill (Const) => emfRecordTypeExtFloodFill
EmfRecordTypeExtSelectClipRgn (Const) => emfRecordTypeExtSelectClipRgn
EmfRecordTypeExtTextOutA (Const) => emfRecordTypeExtTextOutA
EmfRecordTypeExtTextOutW (Const) => emfRecordTypeExtTextOutW
EmfRecordTypeFillPath (Const) => emfRecordTypeFillPath
EmfRecordTypeFillRgn (Const) => emfRecordTypeFillRgn
EmfRecordTypeFlattenPath (Const) => emfRecordTypeFlattenPath
EmfRecordTypeForceUFIMapping (Const) => emfRecordTypeForceUFIMapping
EmfRecordTypeFrameRgn (Const) => emfRecordTypeFrameRgn
EmfRecordTypeGdiComment (Const) => emfRecordTypeGdiComment
EmfRecordTypeGLSBoundedRecord (Const) => emfRecordTypeGLSBoundedRecord
EmfRecordTypeGLSRecord (Const) => emfRecordTypeGLSRecord
EmfRecordTypeGradientFill (Const) => emfRecordTypeGradientFill
EmfRecordTypeHeader (Const) => emfRecordTypeHeader
EmfRecordTypeIntersectClipRect (Const) => emfRecordTypeIntersectClipRect
EmfRecordTypeInvertRgn (Const) => emfRecordTypeInvertRgn
EmfRecordTypeLineTo (Const) => emfRecordTypeLineTo
EmfRecordTypeMaskBlt (Const) => emfRecordTypeMaskBlt
EmfRecordTypeMax (Const) => emfRecordTypeMax
EmfRecordTypeMin (Const) => emfRecordTypeMin
EmfRecordTypeModifyWorldTransform (Const) => emfRecordTypeModifyWorldTransform
EmfRecordTypeMoveToEx (Const) => emfRecordTypeMoveToEx
EmfRecordTypeNamedEscape (Const) => emfRecordTypeNamedEscape
EmfRecordTypeOffsetClipRgn (Const) => emfRecordTypeOffsetClipRgn
EmfRecordTypePaintRgn (Const) => emfRecordTypePaintRgn
EmfRecordTypePie (Const) => emfRecordTypePie
EmfRecordTypePixelFormat (Const) => emfRecordTypePixelFormat
EmfRecordTypePlgBlt (Const) => emfRecordTypePlgBlt
EmfRecordTypePolyBezier (Const) => emfRecordTypePolyBezier
EmfRecordTypePolyBezier16 (Const) => emfRecordTypePolyBezier16
EmfRecordTypePolyBezierTo (Const) => emfRecordTypePolyBezierTo
EmfRecordTypePolyBezierTo16 (Const) => emfRecordTypePolyBezierTo16
EmfRecordTypePolyDraw (Const) => emfRecordTypePolyDraw
EmfRecordTypePolyDraw16 (Const) => emfRecordTypePolyDraw16
EmfRecordTypePolygon (Const) => emfRecordTypePolygon
EmfRecordTypePolygon16 (Const) => emfRecordTypePolygon16
EmfRecordTypePolyline (Const) => emfRecordTypePolyline
EmfRecordTypePolyline16 (Const) => emfRecordTypePolyline16
EmfRecordTypePolyLineTo (Const) => emfRecordTypePolyLineTo
EmfRecordTypePolylineTo16 (Const) => emfRecordTypePolylineTo16
EmfRecordTypePolyPolygon (Const) => emfRecordTypePolyPolygon
EmfRecordTypePolyPolygon16 (Const) => emfRecordTypePolyPolygon16
EmfRecordTypePolyPolyline (Const) => emfRecordTypePolyPolyline
EmfRecordTypePolyPolyline16 (Const) => emfRecordTypePolyPolyline16
EmfRecordTypePolyTextOutA (Const) => emfRecordTypePolyTextOutA
EmfRecordTypePolyTextOutW (Const) => emfRecordTypePolyTextOutW
EmfRecordTypeRealizePalette (Const) => emfRecordTypeRealizePalette
EmfRecordTypeRectangle (Const) => emfRecordTypeRectangle
EmfRecordTypeResizePalette (Const) => emfRecordTypeResizePalette
EmfRecordTypeRestoreDC (Const) => emfRecordTypeRestoreDC
EmfRecordTypeRoundRect (Const) => emfRecordTypeRoundRect
EmfRecordTypeSaveDC (Const) => emfRecordTypeSaveDC
EmfRecordTypeScaleViewportExtEx (Const) => emfRecordTypeScaleViewportExtEx
EmfRecordTypeScaleWindowExtEx (Const) => emfRecordTypeScaleWindowExtEx
EmfRecordTypeSelectClipPath (Const) => emfRecordTypeSelectClipPath
EmfRecordTypeSelectObject (Const) => emfRecordTypeSelectObject
EmfRecordTypeSelectPalette (Const) => emfRecordTypeSelectPalette
EmfRecordTypeSetArcDirection (Const) => emfRecordTypeSetArcDirection
EmfRecordTypeSetBkColor (Const) => emfRecordTypeSetBkColor
EmfRecordTypeSetBkMode (Const) => emfRecordTypeSetBkMode
EmfRecordTypeSetBrushOrgEx (Const) => emfRecordTypeSetBrushOrgEx
EmfRecordTypeSetColorAdjustment (Const) => emfRecordTypeSetColorAdjustment
EmfRecordTypeSetColorSpace (Const) => emfRecordTypeSetColorSpace
EmfRecordTypeSetDIBitsToDevice (Const) => emfRecordTypeSetDIBitsToDevice
EmfRecordTypeSetICMMode (Const) => emfRecordTypeSetICMMode
EmfRecordTypeSetICMProfileA (Const) => emfRecordTypeSetICMProfileA
EmfRecordTypeSetICMProfileW (Const) => emfRecordTypeSetICMProfileW
EmfRecordTypeSetLayout (Const) => emfRecordTypeSetLayout
EmfRecordTypeSetLinkedUFIs (Const) => emfRecordTypeSetLinkedUFIs
EmfRecordTypeSetMapMode (Const) => emfRecordTypeSetMapMode
EmfRecordTypeSetMapperFlags (Const) => emfRecordTypeSetMapperFlags
EmfRecordTypeSetMetaRgn (Const) => emfRecordTypeSetMetaRgn
EmfRecordTypeSetMiterLimit (Const) => emfRecordTypeSetMiterLimit
EmfRecordTypeSetPaletteEntries (Const) => emfRecordTypeSetPaletteEntries
EmfRecordTypeSetPixelV (Const) => emfRecordTypeSetPixelV
EmfRecordTypeSetPolyFillMode (Const) => emfRecordTypeSetPolyFillMode
EmfRecordTypeSetROP2 (Const) => emfRecordTypeSetROP2
EmfRecordTypeSetStretchBltMode (Const) => emfRecordTypeSetStretchBltMode
EmfRecordTypeSetTextAlign (Const) => emfRecordTypeSetTextAlign
EmfRecordTypeSetTextColor (Const) => emfRecordTypeSetTextColor
EmfRecordTypeSetTextJustification (Const) => emfRecordTypeSetTextJustification
EmfRecordTypeSetViewportExtEx (Const) => emfRecordTypeSetViewportExtEx
EmfRecordTypeSetViewportOrgEx (Const) => emfRecordTypeSetViewportOrgEx
EmfRecordTypeSetWindowExtEx (Const) => emfRecordTypeSetWindowExtEx
EmfRecordTypeSetWindowOrgEx (Const) => emfRecordTypeSetWindowOrgEx
EmfRecordTypeSetWorldTransform (Const) => emfRecordTypeSetWorldTransform
EmfRecordTypeSmallTextOut (Const) => emfRecordTypeSmallTextOut
EmfRecordTypeStartDoc (Const) => emfRecordTypeStartDoc
EmfRecordTypeStretchBlt (Const) => emfRecordTypeStretchBlt
EmfRecordTypeStretchDIBits (Const) => emfRecordTypeStretchDIBits
EmfRecordTypeStrokeAndFillPath (Const) => emfRecordTypeStrokeAndFillPath
EmfRecordTypeStrokePath (Const) => emfRecordTypeStrokePath
EmfRecordTypeTransparentBlt (Const) => emfRecordTypeTransparentBlt
EmfRecordTypeWidenPath (Const) => emfRecordTypeWidenPath
EmfToWmfBitsFlagsDefault (Const) => emfToWmfBitsFlagsDefault
EmfToWmfBitsFlagsEmbedEmf (Const) => emfToWmfBitsFlagsEmbedEmf
EmfToWmfBitsFlagsIncludePlaceable (Const) => emfToWmfBitsFlagsIncludePlaceable
EmfToWmfBitsFlagsNoXORClip (Const) => emfToWmfBitsFlagsNoXORClip
EmfTypeEmfOnly (Const) => emfTypeEmfOnly
EmfTypeEmfPlusDual (Const) => emfTypeEmfPlusDual
EmfTypeEmfPlusOnly (Const) => emfTypeEmfPlusOnly
EMR_ABORTPATH (Const) => emrABORTPATH
EMR_ALPHABLEND (Const) => emrALPHABLEND
EMR_ANGLEARC (Const) => emrANGLEARC
EMR_ARC (Const) => emrARC
EMR_ARCTO (Const) => emrARCTO
EMR_BEGINPATH (Const) => emrBEGINPATH
EMR_BITBLT (Const) => emrBITBLT
EMR_CHORD (Const) => emrCHORD
EMR_CLOSEFIGURE (Const) => emrCLOSEFIGURE
EMR_COLORCORRECTPALETTE (Const) => emrCOLORCORRECTPALETTE
EMR_COLORMATCHTOTARGETW (Const) => emrCOLORMATCHTOTARGETW
EMR_CREATEBRUSHINDIRECT (Const) => emrCREATEBRUSHINDIRECT
EMR_CREATECOLORSPACE (Const) => emrCREATECOLORSPACE
EMR_CREATECOLORSPACEW (Const) => emrCREATECOLORSPACEW
EMR_CREATEDIBPATTERNBRUSHPT (Const) => emrCREATEDIBPATTERNBRUSHPT
EMR_CREATEMONOBRUSH (Const) => emrCREATEMONOBRUSH
EMR_CREATEPALETTE (Const) => emrCREATEPALETTE
EMR_CREATEPEN (Const) => emrCREATEPEN
EMR_DELETECOLORSPACE (Const) => emrDELETECOLORSPACE
EMR_DELETEOBJECT (Const) => emrDELETEOBJECT
EMR_ELLIPSE (Const) => emrELLIPSE
EMR_ENDPATH (Const) => emrENDPATH
EMR_EOF (Const) => emrEOF
EMR_EXCLUDECLIPRECT (Const) => emrEXCLUDECLIPRECT
EMR_EXTCREATEFONTINDIRECTW (Const) => emrEXTCREATEFONTINDIRECTW
EMR_EXTCREATEPEN (Const) => emrEXTCREATEPEN
EMR_EXTFLOODFILL (Const) => emrEXTFLOODFILL
EMR_EXTSELECTCLIPRGN (Const) => emrEXTSELECTCLIPRGN
EMR_EXTTEXTOUTA (Const) => emrEXTTEXTOUTA
EMR_EXTTEXTOUTW (Const) => emrEXTTEXTOUTW
EMR_FILLPATH (Const) => emrFILLPATH
EMR_FILLRGN (Const) => emrFILLRGN
EMR_FLATTENPATH (Const) => emrFLATTENPATH
EMR_FRAMERGN (Const) => emrFRAMERGN
EMR_GDICOMMENT (Const) => emrGDICOMMENT
EMR_GLSBOUNDEDRECORD (Const) => emrGLSBOUNDEDRECORD
EMR_GLSRECORD (Const) => emrGLSRECORD
EMR_GRADIENTFILL (Const) => emrGRADIENTFILL
EMR_HEADER (Const) => emrHEADER
EMR_INTERSECTCLIPRECT (Const) => emrINTERSECTCLIPRECT
EMR_INVERTRGN (Const) => emrINVERTRGN
EMR_LINETO (Const) => emrLINETO
EMR_MASKBLT (Const) => emrMASKBLT
EMR_MAX (Const) => emrMAX
EMR_MIN (Const) => emrMIN
EMR_MODIFYWORLDTRANSFORM (Const) => emrMODIFYWORLDTRANSFORM
EMR_MOVETOEX (Const) => emrMOVETOEX
EMR_OFFSETCLIPRGN (Const) => emrOFFSETCLIPRGN
EMR_PAINTRGN (Const) => emrPAINTRGN
EMR_PIE (Const) => emrPIE
EMR_PIXELFORMAT (Const) => emrPIXELFORMAT
EMR_PLGBLT (Const) => emrPLGBLT
EMR_POLYBEZIER (Const) => emrPOLYBEZIER
EMR_POLYBEZIER16 (Const) => emrPOLYBEZIER16
EMR_POLYBEZIERTO (Const) => emrPOLYBEZIERTO
EMR_POLYBEZIERTO16 (Const) => emrPOLYBEZIERTO16
EMR_POLYDRAW (Const) => emrPOLYDRAW
EMR_POLYDRAW16 (Const) => emrPOLYDRAW16
EMR_POLYGON (Const) => emrPOLYGON
EMR_POLYGON16 (Const) => emrPOLYGON16
EMR_POLYLINE (Const) => emrPOLYLINE
EMR_POLYLINE16 (Const) => emrPOLYLINE16
EMR_POLYLINETO (Const) => emrPOLYLINETO
EMR_POLYLINETO16 (Const) => emrPOLYLINETO16
EMR_POLYPOLYGON (Const) => emrPOLYPOLYGON
EMR_POLYPOLYGON16 (Const) => emrPOLYPOLYGON16
EMR_POLYPOLYLINE (Const) => emrPOLYPOLYLINE
EMR_POLYPOLYLINE16 (Const) => emrPOLYPOLYLINE16
EMR_POLYTEXTOUTA (Const) => emrPOLYTEXTOUTA
EMR_POLYTEXTOUTW (Const) => emrPOLYTEXTOUTW
EMR_REALIZEPALETTE (Const) => emrREALIZEPALETTE
EMR_RECTANGLE (Const) => emrRECTANGLE
EMR_RESERVED_105 (Const) => emrRESERVED_105
EMR_RESERVED_106 (Const) => emrRESERVED_106
EMR_RESERVED_107 (Const) => emrRESERVED_107
EMR_RESERVED_108 (Const) => emrRESERVED_108
EMR_RESERVED_109 (Const) => emrRESERVED_109
EMR_RESERVED_110 (Const) => emrRESERVED_110
EMR_RESERVED_117 (Const) => emrRESERVED_117
EMR_RESERVED_119 (Const) => emrRESERVED_119
EMR_RESERVED_120 (Const) => emrRESERVED_120
EMR_RESIZEPALETTE (Const) => emrRESIZEPALETTE
EMR_RESTOREDC (Const) => emrRESTOREDC
EMR_ROUNDRECT (Const) => emrROUNDRECT
EMR_SAVEDC (Const) => emrSAVEDC
EMR_SCALEVIEWPORTEXTEX (Const) => emrSCALEVIEWPORTEXTEX
EMR_SCALEWINDOWEXTEX (Const) => emrSCALEWINDOWEXTEX
EMR_SELECTCLIPPATH (Const) => emrSELECTCLIPPATH
EMR_SELECTOBJECT (Const) => emrSELECTOBJECT
EMR_SELECTPALETTE (Const) => emrSELECTPALETTE
EMR_SETARCDIRECTION (Const) => emrSETARCDIRECTION
EMR_SETBKCOLOR (Const) => emrSETBKCOLOR
EMR_SETBKMODE (Const) => emrSETBKMODE
EMR_SETBRUSHORGEX (Const) => emrSETBRUSHORGEX
EMR_SETCOLORADJUSTMENT (Const) => emrSETCOLORADJUSTMENT
EMR_SETCOLORSPACE (Const) => emrSETCOLORSPACE
EMR_SETDIBITSTODEVICE (Const) => emrSETDIBITSTODEVICE
EMR_SETICMMODE (Const) => emrSETICMMODE
EMR_SETICMPROFILEA (Const) => emrSETICMPROFILEA
EMR_SETICMPROFILEW (Const) => emrSETICMPROFILEW
EMR_SETLAYOUT (Const) => emrSETLAYOUT
EMR_SETMAPMODE (Const) => emrSETMAPMODE
EMR_SETMAPPERFLAGS (Const) => emrSETMAPPERFLAGS
EMR_SETMETARGN (Const) => emrSETMETARGN
EMR_SETMITERLIMIT (Const) => emrSETMITERLIMIT
EMR_SETPALETTEENTRIES (Const) => emrSETPALETTEENTRIES
EMR_SETPIXELV (Const) => emrSETPIXELV
EMR_SETPOLYFILLMODE (Const) => emrSETPOLYFILLMODE
EMR_SETROP2 (Const) => emrSETROP2
EMR_SETSTRETCHBLTMODE (Const) => emrSETSTRETCHBLTMODE
EMR_SETTEXTALIGN (Const) => emrSETTEXTALIGN
EMR_SETTEXTCOLOR (Const) => emrSETTEXTCOLOR
EMR_SETVIEWPORTEXTEX (Const) => emrSETVIEWPORTEXTEX
EMR_SETVIEWPORTORGEX (Const) => emrSETVIEWPORTORGEX
EMR_SETWINDOWEXTEX (Const) => emrSETWINDOWEXTEX
EMR_SETWINDOWORGEX (Const) => emrSETWINDOWORGEX
EMR_SETWORLDTRANSFORM (Const) => emrSETWORLDTRANSFORM
EMR_STRETCHBLT (Const) => emrSTRETCHBLT
EMR_STRETCHDIBITS (Const) => emrSTRETCHDIBITS
EMR_STROKEANDFILLPATH (Const) => emrSTROKEANDFILLPATH
EMR_STROKEPATH (Const) => emrSTROKEPATH
EMR_TRANSPARENTBLT (Const) => emrTRANSPARENTBLT
EMR_WIDENPATH (Const) => emrWIDENPATH
EnableMultiBatteryDisplay (Const) => enableMultiBatteryDisplay
EnablePasswordLogon (Const) => enablePasswordLogon
EnableSysTrayBatteryMeter (Const) => enableSysTrayBatteryMeter
EnableVideoDimDisplay (Const) => enableVideoDimDisplay
EnableWakeOnRing (Const) => enableWakeOnRing
EncoderParameterValueTypeASCII (Const) => encoderParameterValueTypeASCII
EncoderParameterValueTypeByte (Const) => encoderParameterValueTypeByte
EncoderParameterValueTypeLong (Const) => encoderParameterValueTypeLong
EncoderParameterValueTypeLongRange (Const) => encoderParameterValueTypeLongRange
EncoderParameterValueTypePointer (Const) => encoderParameterValueTypePointer
EncoderParameterValueTypeRational (Const) => encoderParameterValueTypeRational
EncoderParameterValueTypeRationalRange (Const) => encoderParameterValueTypeRationalRange
EncoderParameterValueTypeShort (Const) => encoderParameterValueTypeShort
EncoderParameterValueTypeUndefined (Const) => encoderParameterValueTypeUndefined
EncoderValueColorTypeCMYK (Const) => encoderValueColorTypeCMYK
EncoderValueColorTypeYCCK (Const) => encoderValueColorTypeYCCK
EncoderValueCompressionCCITT3 (Const) => encoderValueCompressionCCITT3
EncoderValueCompressionCCITT4 (Const) => encoderValueCompressionCCITT4
EncoderValueCompressionLZW (Const) => encoderValueCompressionLZW
EncoderValueCompressionNone (Const) => encoderValueCompressionNone
EncoderValueCompressionRle (Const) => encoderValueCompressionRle
EncoderValueFlush (Const) => encoderValueFlush
EncoderValueFrameDimensionPage (Const) => encoderValueFrameDimensionPage
EncoderValueFrameDimensionResolution (Const) => encoderValueFrameDimensionResolution
EncoderValueFrameDimensionTime (Const) => encoderValueFrameDimensionTime
EncoderValueLastFrame (Const) => encoderValueLastFrame
EncoderValueMultiFrame (Const) => encoderValueMultiFrame
EncoderValueRenderNonProgressive (Const) => encoderValueRenderNonProgressive
EncoderValueRenderProgressive (Const) => encoderValueRenderProgressive
EncoderValueScanMethodInterlaced (Const) => encoderValueScanMethodInterlaced
EncoderValueScanMethodNonInterlaced (Const) => encoderValueScanMethodNonInterlaced
EncoderValueTransformFlipHorizontal (Const) => encoderValueTransformFlipHorizontal
EncoderValueTransformFlipVertical (Const) => encoderValueTransformFlipVertical
EncoderValueTransformRotate180 (Const) => encoderValueTransformRotate180
EncoderValueTransformRotate270 (Const) => encoderValueTransformRotate270
EncoderValueTransformRotate90 (Const) => encoderValueTransformRotate90
EncoderValueVersionGif87 (Const) => encoderValueVersionGif87
EncoderValueVersionGif89 (Const) => encoderValueVersionGif89
ENCORRECTTEXT (Object) => TENCORRECTTEXT
END_PATH (Const) => endPath
ENDDOC (Const) => endDoc
ENDROPFILES (Object) => TENDROPFILES
ENLINK (Object) => TENLINK
EnlistmentBasicInformation (Const) => enlistmentBasicInformation
EnlistmentCrmInformation (Const) => enlistmentCrmInformation
EnlistmentRecoveryInformation (Const) => enlistmentRecoveryInformation
ENLOWFIRTF (Object) => TENLOWFIRTF
ENOLEOPFAILED (Object) => TENOLEOPFAILED
ENPROTECTED (Object) => TENPROTECTED
ENSAVECLIPBOARD (Object) => TENSAVECLIPBOARD
EqualPriority (Const) => equalPriority
ExceptionCollidedUnwind (Const) => exceptionCollidedUnwind
ExceptionContinueExecution (Const) => exceptionContinueExecution
ExceptionContinueSearch (Const) => exceptionContinueSearch
ExceptionExecuteHandler (Const) => exceptionExecuteHandler
ExceptionNestedException (Const) => exceptionNestedException
ExceptionStream (Const) => exceptionStream
Executive (Const) => executive
ExitLatencySamplingPercentage (Const) => exitLatencySamplingPercentage
EXPLICIT_ACCESS_ (Type) => EXPLICIT_ACCESS
ExtendedFileIdType (Const) => extendedFileIdType
ExtendedProperty (Object) => TExtendedProperty
EXTTEXTOUT (Const) => extTextout
FileAccessInformation (Const) => fileAccessInformation
FileAlignmentInfo (Const) => fileAlignmentInfo
FileAlignmentInformation (Const) => fileAlignmentInformation
FileAllInformation (Const) => fileAllInformation
FileAllocationInfo (Const) => fileAllocationInfo
FileAllocationInformation (Const) => fileAllocationInformation
FileAlternateNameInformation (Const) => fileAlternateNameInformation
FileAttributeTagInfo (Const) => fileAttributeTagInfo
FileAttributeTagInformation (Const) => fileAttributeTagInformation
FileBasicInfo (Const) => fileBasicInfo
FileBasicInformation (Const) => fileBasicInformation
FileBothDirectoryInformation (Const) => fileBothDirectoryInformation
FileCompletionInformation (Const) => fileCompletionInformation
FileCompressionInfo (Const) => fileCompressionInfo
FileCompressionInformation (Const) => fileCompressionInformation
FileDirectoryInformation (Const) => fileDirectoryInformation
FileDispositionInfo (Const) => fileDispositionInfo
FileDispositionInformation (Const) => fileDispositionInformation
FileEaInformation (Const) => fileEaInformation
FileEndOfFileInfo (Const) => fileEndOfFileInfo
FileEndOfFileInformation (Const) => fileEndOfFileInformation
FileFsAttributeInformation (Const) => fileFsAttributeInformation
FileFsControlInformation (Const) => fileFsControlInformation
FileFsDeviceInformation (Const) => fileFsDeviceInformation
FileFsDriverPathInformation (Const) => fileFsDriverPathInformation
FileFsFullSizeInformation (Const) => fileFsFullSizeInformation
FileFsLabelInformation (Const) => fileFsLabelInformation
FileFsMaximumInformation (Const) => fileFsMaximumInformation
FileFsObjectIdInformation (Const) => fileFsObjectIdInformation
FileFsSizeInformation (Const) => fileFsSizeInformation
FileFsVolumeFlagsInformation (Const) => fileFsVolumeFlagsInformation
FileFsVolumeInformation (Const) => fileFsVolumeInformation
FileFullDirectoryInfo (Const) => fileFullDirectoryInfo
FileFullDirectoryInformation (Const) => fileFullDirectoryInformation
FileFullDirectoryRestartInfo (Const) => fileFullDirectoryRestartInfo
FileFullEaInformation (Const) => fileFullEaInformation
FileHardLinkInformation (Const) => fileHardLinkInformation
FileIdBothDirectoryInfo (Const) => fileIdBothDirectoryInfo
FileIdBothDirectoryInformation (Const) => fileIdBothDirectoryInformation
FileIdBothDirectoryRestartInfo (Const) => fileIdBothDirectoryRestartInfo
FileIdExtdDirectoryInfo (Const) => fileIdExtdDirectoryInfo
FileIdExtdDirectoryRestartInfo (Const) => fileIdExtdDirectoryRestartInfo
FileIdFullDirectoryInformation (Const) => fileIdFullDirectoryInformation
FileIdGlobalTxDirectoryInformation (Const) => fileIdGlobalTxDirectoryInformation
FileIdInfo (Const) => fileIdInfo
FileIdType (Const) => fileIdType
FileInformationInAssemblyOfAssemblyInActivationContext (Const) => fileInformationInAssemblyOfAssemblyInActivationContext
FileInformationInAssemblyOfAssemblyInActivationContxt (Const) => fileInformationInAssemblyOfAssemblyInActivationContxt
FileInternalInformation (Const) => fileInternalInformation
FileIoPriorityHintInfo (Const) => fileIoPriorityHintInfo
FileLinkInformation (Const) => fileLinkInformation
FileMailslotQueryInformation (Const) => fileMailslotQueryInformation
FileMailslotSetInformation (Const) => fileMailslotSetInformation
FileMaximumInformation (Const) => fileMaximumInformation
FileModeInformation (Const) => fileModeInformation
FileMoveClusterInformation (Const) => fileMoveClusterInformation
FileNameInfo (Const) => fileNameInfo
FileNameInformation (Const) => fileNameInformation
FileNamesInformation (Const) => fileNamesInformation
FileNetworkOpenInformation (Const) => fileNetworkOpenInformation
FileNormalizedNameInformation (Const) => fileNormalizedNameInformation
FileNotFound (Const) => fileNotFound
FileObjectIdInformation (Const) => fileObjectIdInformation
FilePipeInformation (Const) => filePipeInformation
FilePipeLocalInformation (Const) => filePipeLocalInformation
FilePipeRemoteInformation (Const) => filePipeRemoteInformation
FilePositionInformation (Const) => filePositionInformation
FileQuotaInformation (Const) => fileQuotaInformation
FileRemoteProtocolInfo (Const) => fileRemoteProtocolInfo
FileRenameInfo (Const) => fileRenameInfo
FileRenameInformation (Const) => fileRenameInformation
FileReparsePointInformation (Const) => fileReparsePointInformation
FileSfioReserveInformation (Const) => fileSfioReserveInformation
FileSfioVolumeInformation (Const) => fileSfioVolumeInformation
FileShortNameInformation (Const) => fileShortNameInformation
FileStandardInfo (Const) => fileStandardInfo
FileStandardInformation (Const) => fileStandardInformation
FileStandardLinkInformation (Const) => fileStandardLinkInformation
FileStorageInfo (Const) => fileStorageInfo
FileStreamInfo (Const) => fileStreamInfo
FileStreamInformation (Const) => fileStreamInformation
FileSystemType (Const) => fileSystemType
FileTrackingInformation (Const) => fileTrackingInformation
FileValidDataLengthInformation (Const) => fileValidDataLengthInformation
FillMode (Type) => GpFillMode
FillModeAlternate (Const) => fillModeAlternate
FillModeWinding (Const) => fillModeWinding
FIND_FROM_START (Const) => VFW_FIND_FROM_START
FindExInfoBasic (Const) => findExInfoBasic
FindExInfoMaxInfoLevel (Const) => findExInfoMaxInfoLevel
FindExInfoStandard (Const) => findExInfoStandard
FindExSearchLimitToDevices (Const) => findExSearchLimitToDevices
FindExSearchLimitToDirectories (Const) => findExSearchLimitToDirectories
FindExSearchMaxSearchOp (Const) => findExSearchMaxSearchOp
FindExSearchNameMatch (Const) => findExSearchNameMatch
FindStreamInfoMaxInfoLevel (Const) => findStreamInfoMaxInfoLevel
FindStreamInfoStandard (Const) => findStreamInfoStandard
FINDTEXT (Type) => TFINDTEXT
FINDTEXTA (Object) => TFINDTEXTA
FINDTEXTW (Object) => TFINDTEXTW
FirmwareTableInformationRegistered (Const) => firmwareTableInformationRegistered
FirmwareTypeBios (Const) => firmwareTypeBios
FirmwareTypeMax (Const) => firmwareTypeMax
FirmwareTypeUefi (Const) => firmwareTypeUefi
FirmwareTypeUnknown (Const) => firmwareTypeUnknown
FixedMedia (Const) => fixedMedia
FlatnessDefault (Const) => flatnessDefault
FloppyClassGuid (Const) => floppyClassGuid
FlushIntention (Type) => GpFlushIntention
FlushIntentionFlush (Const) => flushIntentionFlush
FlushIntentionSync (Const) => flushIntentionSync
FontFamilyNotFound (Const) => fontFamilyNotFound
FontStyleBold (Const) => fontStyleBold
FontStyleBoldItalic (Const) => fontStyleBoldItalic
FontStyleItalic (Const) => fontStyleItalic
FontStyleNotFound (Const) => fontStyleNotFound
FontStyleRegular (Const) => fontStyleRegular
FontStyleStrikeout (Const) => fontStyleStrikeout
FontStyleUnderline (Const) => fontStyleUnderline
ForcedShutdown (Const) => forcedShutdown
ForestTrustDomainInfo (Const) => forestTrustDomainInfo
ForestTrustRecordTypeLast (Const) => forestTrustRecordTypeLast
ForestTrustTopLevelName (Const) => forestTrustTopLevelName
ForestTrustTopLevelNameEx (Const) => forestTrustTopLevelNameEx
FreePage (Const) => freePage
FunctionTableStream (Const) => functionTableStream
GdiplusNotInitialized (Const) => gdiplusNotInitialized
GenericError (Const) => genericError
GetFileExInfoStandard (Const) => getFileExInfoStandard
GetFileExMaxInfoLevel (Const) => getFileExMaxInfoLevel
GetPowerRequestList (Const) => getPowerRequestList
GetPowerSettingValue (Const) => getPowerSettingValue
GroupPark (Const) => groupPark
HandleDataStream (Const) => handleDataStream
HandleOperationListStream (Const) => handleOperationListStream
HatchStyle (Type) => GpHatchStyle
HatchStyle05Percent (Const) => hatchStyle05Percent
HatchStyle10Percent (Const) => hatchStyle10Percent
HatchStyle20Percent (Const) => hatchStyle20Percent
HatchStyle25Percent (Const) => hatchStyle25Percent
HatchStyle30Percent (Const) => hatchStyle30Percent
HatchStyle40Percent (Const) => hatchStyle40Percent
HatchStyle50Percent (Const) => hatchStyle50Percent
HatchStyle60Percent (Const) => hatchStyle60Percent
HatchStyle70Percent (Const) => hatchStyle70Percent
HatchStyle75Percent (Const) => hatchStyle75Percent
HatchStyle80Percent (Const) => hatchStyle80Percent
HatchStyle90Percent (Const) => hatchStyle90Percent
HatchStyleBackwardDiagonal (Const) => hatchStyleBackwardDiagonal
HatchStyleCross (Const) => hatchStyleCross
HatchStyleDarkDownwardDiagonal (Const) => hatchStyleDarkDownwardDiagonal
HatchStyleDarkHorizontal (Const) => hatchStyleDarkHorizontal
HatchStyleDarkUpwardDiagonal (Const) => hatchStyleDarkUpwardDiagonal
HatchStyleDarkVertical (Const) => hatchStyleDarkVertical
HatchStyleDashedDownwardDiagonal (Const) => hatchStyleDashedDownwardDiagonal
HatchStyleDashedHorizontal (Const) => hatchStyleDashedHorizontal
HatchStyleDashedUpwardDiagonal (Const) => hatchStyleDashedUpwardDiagonal
HatchStyleDashedVertical (Const) => hatchStyleDashedVertical
HatchStyleDiagonalBrick (Const) => hatchStyleDiagonalBrick
HatchStyleDiagonalCross (Const) => hatchStyleDiagonalCross
HatchStyleDivot (Const) => hatchStyleDivot
HatchStyleDottedDiamond (Const) => hatchStyleDottedDiamond
HatchStyleDottedGrid (Const) => hatchStyleDottedGrid
HatchStyleForwardDiagonal (Const) => hatchStyleForwardDiagonal
HatchStyleHorizontal (Const) => hatchStyleHorizontal
HatchStyleHorizontalBrick (Const) => hatchStyleHorizontalBrick
HatchStyleLargeCheckerBoard (Const) => hatchStyleLargeCheckerBoard
HatchStyleLargeConfetti (Const) => hatchStyleLargeConfetti
HatchStyleLargeGrid (Const) => hatchStyleLargeGrid
HatchStyleLightDownwardDiagonal (Const) => hatchStyleLightDownwardDiagonal
HatchStyleLightHorizontal (Const) => hatchStyleLightHorizontal
HatchStyleLightUpwardDiagonal (Const) => hatchStyleLightUpwardDiagonal
HatchStyleLightVertical (Const) => hatchStyleLightVertical
HatchStyleMax (Const) => hatchStyleMax
HatchStyleMin (Const) => hatchStyleMin
HatchStyleNarrowHorizontal (Const) => hatchStyleNarrowHorizontal
HatchStyleNarrowVertical (Const) => hatchStyleNarrowVertical
HatchStyleOutlinedDiamond (Const) => hatchStyleOutlinedDiamond
HatchStylePlaid (Const) => hatchStylePlaid
HatchStyleShingle (Const) => hatchStyleShingle
HatchStyleSmallCheckerBoard (Const) => hatchStyleSmallCheckerBoard
HatchStyleSmallConfetti (Const) => hatchStyleSmallConfetti
HatchStyleSmallGrid (Const) => hatchStyleSmallGrid
HatchStyleSolidDiamond (Const) => hatchStyleSolidDiamond
HatchStyleSphere (Const) => hatchStyleSphere
HatchStyleTotal (Const) => hatchStyleTotal
HatchStyleTrellis (Const) => hatchStyleTrellis
HatchStyleVertical (Const) => hatchStyleVertical
HatchStyleWave (Const) => hatchStyleWave
HatchStyleWeave (Const) => hatchStyleWeave
HatchStyleWideDownwardDiagonal (Const) => hatchStyleWideDownwardDiagonal
HatchStyleWideUpwardDiagonal (Const) => hatchStyleWideUpwardDiagonal
HatchStyleZigZag (Const) => hatchStyleZigZag
HeaderWaitTimeout (Const) => headerWaitTimeout
HeadingLevel1 (Const) => headingLevel1
HeadingLevel2 (Const) => headingLevel2
HeadingLevel3 (Const) => headingLevel3
HeadingLevel4 (Const) => headingLevel4
HeadingLevel5 (Const) => headingLevel5
HeadingLevel6 (Const) => headingLevel6
HeadingLevel7 (Const) => headingLevel7
HeadingLevel8 (Const) => headingLevel8
HeadingLevel9 (Const) => headingLevel9
HEAP_SUMMARY (Object) => THEAP_SUMMARY
HeapCompatibilityInformation (Const) => heapCompatibilityInformation
HeapEnableTerminationOnCorruption (Const) => heapEnableTerminationOnCorruption
HighMemoryResourceNotification (Const) => highMemoryResourceNotification
HistogramFormatA (Const) => histogramFormatA
HistogramFormatARGB (Const) => histogramFormatARGB
HistogramFormatB (Const) => histogramFormatB
HistogramFormatG (Const) => histogramFormatG
HistogramFormatGray (Const) => histogramFormatGray
HistogramFormatPARGB (Const) => histogramFormatPARGB
HistogramFormatR (Const) => histogramFormatR
HistogramFormatRGB (Const) => histogramFormatRGB
HotkeyPrefixHide (Const) => hotkeyPrefixHide
HotkeyPrefixNone (Const) => hotkeyPrefixNone
HotkeyPrefixShow (Const) => hotkeyPrefixShow
HTMLAppFlag0 (Const) => hTMLAppFlag0
HTMLAppFlag1 (Const) => hTMLAppFlag1
HTMLAppFlagNo (Const) => hTMLAppFlagNo
HTMLAppFlagOff (Const) => hTMLAppFlagOff
HTMLAppFlagOn (Const) => hTMLAppFlagOn
HTMLAppFlagYes (Const) => hTMLAppFlagYes
HTMLBorderDialog (Const) => hTMLBorderDialog
HTMLBorderNone (Const) => hTMLBorderNone
HTMLBorderStylecombined (Const) => hTMLBorderStylecombined
HTMLBorderStyleNormal (Const) => hTMLBorderStyleNormal
HTMLBorderStyleRaised (Const) => hTMLBorderStyleRaised
HTMLBorderStyleStatic (Const) => hTMLBorderStyleStatic
HTMLBorderStyleSunken (Const) => hTMLBorderStyleSunken
HTMLBorderThick (Const) => hTMLBorderThick
HTMLBorderThin (Const) => hTMLBorderThin
HTMLCaptionFlagNo (Const) => hTMLCaptionFlagNo
HTMLCaptionFlagYes (Const) => hTMLCaptionFlagYes
HTMLDlgBorderThick (Const) => hTMLDlgBorderThick
HTMLDlgBorderThin (Const) => hTMLDlgBorderThin
HTMLDlgCenter0 (Const) => hTMLDlgCenter0
HTMLDlgCenter1 (Const) => hTMLDlgCenter1
HTMLDlgCenterDesktop (Const) => hTMLDlgCenterDesktop
HTMLDlgCenterNo (Const) => hTMLDlgCenterNo
HTMLDlgCenterOff (Const) => hTMLDlgCenterOff
HTMLDlgCenterOn (Const) => hTMLDlgCenterOn
HTMLDlgCenterParent (Const) => hTMLDlgCenterParent
HTMLDlgCenterYes (Const) => hTMLDlgCenterYes
HTMLDlgEdgeRaised (Const) => hTMLDlgEdgeRaised
HTMLDlgEdgeSunken (Const) => hTMLDlgEdgeSunken
HTMLDlgFlag0 (Const) => hTMLDlgFlag0
HTMLDlgFlag1 (Const) => hTMLDlgFlag1
HTMLDlgFlagNo (Const) => hTMLDlgFlagNo
HTMLDlgFlagNotSet (Const) => hTMLDlgFlagNotSet
HTMLDlgFlagOff (Const) => hTMLDlgFlagOff
HTMLDlgFlagOn (Const) => hTMLDlgFlagOn
HTMLDlgFlagYes (Const) => hTMLDlgFlagYes
HTMLMaximizeFlagNo (Const) => hTMLMaximizeFlagNo
HTMLMaximizeFlagYes (Const) => hTMLMaximizeFlagYes
HTMLMinimizeFlagNo (Const) => hTMLMinimizeFlagNo
HTMLMinimizeFlagYes (Const) => hTMLMinimizeFlagYes
HTMLSysMenuFlagNo (Const) => hTMLSysMenuFlagNo
HTMLSysMenuFlagYes (Const) => hTMLSysMenuFlagYes
HTMLWindowStateMaximize (Const) => hTMLWindowStateMaximize
HTMLWindowStateMinimize (Const) => hTMLWindowStateMinimize
HTMLWindowStateNormal (Const) => hTMLWindowStateNormal
Http503ResponseVerbosityBasic (Const) => http503ResponseVerbosityBasic
Http503ResponseVerbosityFull (Const) => http503ResponseVerbosityFull
Http503ResponseVerbosityLimited (Const) => http503ResponseVerbosityLimited
HttpAuthenticationHardeningLegacy (Const) => httpAuthenticationHardeningLegacy
HttpAuthenticationHardeningMedium (Const) => httpAuthenticationHardeningMedium
HttpAuthenticationHardeningStrict (Const) => httpAuthenticationHardeningStrict
HttpAuthStatusFailure (Const) => httpAuthStatusFailure
HttpAuthStatusNotAuthenticated (Const) => httpAuthStatusNotAuthenticated
HttpAuthStatusSuccess (Const) => httpAuthStatusSuccess
HttpCachePolicyMaximum (Const) => httpCachePolicyMaximum
HttpCachePolicyNocache (Const) => httpCachePolicyNocache
HttpCachePolicyTimeToLive (Const) => httpCachePolicyTimeToLive
HttpCachePolicyUserInvalidates (Const) => httpCachePolicyUserInvalidates
HttpDataChunkFromFileHandle (Const) => httpDataChunkFromFileHandle
HttpDataChunkFromFragmentCache (Const) => httpDataChunkFromFragmentCache
HttpDataChunkFromFragmentCacheEx (Const) => httpDataChunkFromFragmentCacheEx
HttpDataChunkFromMemory (Const) => httpDataChunkFromMemory
HttpDataChunkMaximum (Const) => httpDataChunkMaximum
HttpEnabledStateActive (Const) => httpEnabledStateActive
HttpEnabledStateInactive (Const) => httpEnabledStateInactive
HttpHeaderAccept (Const) => httpHeaderAccept
HttpHeaderAcceptCharset (Const) => httpHeaderAcceptCharset
HttpHeaderAcceptEncoding (Const) => httpHeaderAcceptEncoding
HttpHeaderAcceptLanguage (Const) => httpHeaderAcceptLanguage
HttpHeaderAcceptRanges (Const) => httpHeaderAcceptRanges
HttpHeaderAge (Const) => httpHeaderAge
HttpHeaderAllow (Const) => httpHeaderAllow
HttpHeaderAuthorization (Const) => httpHeaderAuthorization
HttpHeaderCacheControl (Const) => httpHeaderCacheControl
HttpHeaderConnection (Const) => httpHeaderConnection
HttpHeaderContentEncoding (Const) => httpHeaderContentEncoding
HttpHeaderContentLanguage (Const) => httpHeaderContentLanguage
HttpHeaderContentLength (Const) => httpHeaderContentLength
HttpHeaderContentLocation (Const) => httpHeaderContentLocation
HttpHeaderContentMd5 (Const) => httpHeaderContentMd5
HttpHeaderContentRange (Const) => httpHeaderContentRange
HttpHeaderContentType (Const) => httpHeaderContentType
HttpHeaderCookie (Const) => httpHeaderCookie
HttpHeaderDate (Const) => httpHeaderDate
HttpHeaderEtag (Const) => httpHeaderEtag
HttpHeaderExpect (Const) => httpHeaderExpect
HttpHeaderExpires (Const) => httpHeaderExpires
HttpHeaderFrom (Const) => httpHeaderFrom
HttpHeaderHost (Const) => httpHeaderHost
HttpHeaderIfMatch (Const) => httpHeaderIfMatch
HttpHeaderIfModifiedSince (Const) => httpHeaderIfModifiedSince
HttpHeaderIfNoneMatch (Const) => httpHeaderIfNoneMatch
HttpHeaderIfRange (Const) => httpHeaderIfRange
HttpHeaderIfUnmodifiedSince (Const) => httpHeaderIfUnmodifiedSince
HttpHeaderKeepAlive (Const) => httpHeaderKeepAlive
HttpHeaderLastModified (Const) => httpHeaderLastModified
HttpHeaderLocation (Const) => httpHeaderLocation
HttpHeaderMaxForwards (Const) => httpHeaderMaxForwards
HttpHeaderMaximum (Const) => httpHeaderMaximum
HttpHeaderPragma (Const) => httpHeaderPragma
HttpHeaderProxyAuthenticate (Const) => httpHeaderProxyAuthenticate
HttpHeaderProxyAuthorization (Const) => httpHeaderProxyAuthorization
HttpHeaderRange (Const) => httpHeaderRange
HttpHeaderReferer (Const) => httpHeaderReferer
HttpHeaderRequestMaximum (Const) => httpHeaderRequestMaximum
HttpHeaderResponseMaximum (Const) => httpHeaderResponseMaximum
HttpHeaderRetryAfter (Const) => httpHeaderRetryAfter
HttpHeaderServer (Const) => httpHeaderServer
HttpHeaderSetCookie (Const) => httpHeaderSetCookie
HttpHeaderTe (Const) => httpHeaderTe
HttpHeaderTrailer (Const) => httpHeaderTrailer
HttpHeaderTransferEncoding (Const) => httpHeaderTransferEncoding
HttpHeaderTranslate (Const) => httpHeaderTranslate
HttpHeaderUpgrade (Const) => httpHeaderUpgrade
HttpHeaderUserAgent (Const) => httpHeaderUserAgent
HttpHeaderVary (Const) => httpHeaderVary
HttpHeaderVia (Const) => httpHeaderVia
HttpHeaderWarning (Const) => httpHeaderWarning
HttpHeaderWwwAuthenticate (Const) => httpHeaderWwwAuthenticate
HttpLogDataTypeFields (Const) => httpLogDataTypeFields
HttpLoggingRolloverDaily (Const) => httpLoggingRolloverDaily
HttpLoggingRolloverHourly (Const) => httpLoggingRolloverHourly
HttpLoggingRolloverMonthly (Const) => httpLoggingRolloverMonthly
HttpLoggingRolloverSize (Const) => httpLoggingRolloverSize
HttpLoggingRolloverWeekly (Const) => httpLoggingRolloverWeekly
HttpLoggingTypeIIS (Const) => httpLoggingTypeIIS
HttpLoggingTypeNCSA (Const) => httpLoggingTypeNCSA
HttpLoggingTypeRaw (Const) => httpLoggingTypeRaw
HttpLoggingTypeW3C (Const) => httpLoggingTypeW3C
HttpQosSettingTypeBandwidth (Const) => httpQosSettingTypeBandwidth
HttpQosSettingTypeConnectionLimit (Const) => httpQosSettingTypeConnectionLimit
HttpQosSettingTypeFlowRate (Const) => httpQosSettingTypeFlowRate
HttpRequestAuthTypeBasic (Const) => httpRequestAuthTypeBasic
HttpRequestAuthTypeDigest (Const) => httpRequestAuthTypeDigest
HttpRequestAuthTypeKerberos (Const) => httpRequestAuthTypeKerberos
HttpRequestAuthTypeNegotiate (Const) => httpRequestAuthTypeNegotiate
HttpRequestAuthTypeNone (Const) => httpRequestAuthTypeNone
HttpRequestAuthTypeNTLM (Const) => httpRequestAuthTypeNTLM
HttpRequestInfoTypeAuth (Const) => httpRequestInfoTypeAuth
HttpResponseInfoTypeAuthenticationProperty (Const) => httpResponseInfoTypeAuthenticationProperty
HttpResponseInfoTypeChannelBind (Const) => httpResponseInfoTypeChannelBind
HttpResponseInfoTypeMultipleKnownHeaders (Const) => httpResponseInfoTypeMultipleKnownHeaders
HttpResponseInfoTypeQosProperty (Const) => httpResponseInfoTypeQosProperty
HttpServer503VerbosityProperty (Const) => httpServer503VerbosityProperty
HttpServerAuthenticationProperty (Const) => httpServerAuthenticationProperty
HttpServerBindingProperty (Const) => httpServerBindingProperty
HttpServerChannelBindProperty (Const) => httpServerChannelBindProperty
HttpServerExtendedAuthenticationProperty (Const) => httpServerExtendedAuthenticationProperty
HttpServerListenEndpointProperty (Const) => httpServerListenEndpointProperty
HttpServerLoggingProperty (Const) => httpServerLoggingProperty
HttpServerQosProperty (Const) => httpServerQosProperty
HttpServerQueueLengthProperty (Const) => httpServerQueueLengthProperty
HttpServerStateProperty (Const) => httpServerStateProperty
HttpServerTimeoutsProperty (Const) => httpServerTimeoutsProperty
HttpServiceBindingTypeA (Const) => httpServiceBindingTypeA
HttpServiceBindingTypeNone (Const) => httpServiceBindingTypeNone
HttpServiceBindingTypeW (Const) => httpServiceBindingTypeW
HttpServiceConfigIPListenList (Const) => httpServiceConfigIPListenList
HttpServiceConfigMax (Const) => httpServiceConfigMax
HttpServiceConfigQueryExact (Const) => httpServiceConfigQueryExact
HttpServiceConfigQueryMax (Const) => httpServiceConfigQueryMax
HttpServiceConfigQueryNext (Const) => httpServiceConfigQueryNext
HttpServiceConfigSSLCertInfo (Const) => httpServiceConfigSSLCertInfo
HttpServiceConfigUrlAclInfo (Const) => httpServiceConfigUrlAclInfo
HttpVerbCONNECT (Const) => httpVerbCONNECT
HttpVerbCOPY (Const) => httpVerbCOPY
HttpVerbDELETE (Const) => httpVerbDELETE
HttpVerbGET (Const) => httpVerbGET
HttpVerbHEAD (Const) => httpVerbHEAD
HttpVerbInvalid (Const) => httpVerbInvalid
HttpVerbLOCK (Const) => httpVerbLOCK
HttpVerbMaximum (Const) => httpVerbMaximum
HttpVerbMKCOL (Const) => httpVerbMKCOL
HttpVerbMOVE (Const) => httpVerbMOVE
HttpVerbOPTIONS (Const) => httpVerbOPTIONS
HttpVerbPOST (Const) => httpVerbPOST
HttpVerbPROPFIND (Const) => httpVerbPROPFIND
HttpVerbPROPPATCH (Const) => httpVerbPROPPATCH
HttpVerbPUT (Const) => httpVerbPUT
HttpVerbSEARCH (Const) => httpVerbSEARCH
HttpVerbTRACE (Const) => httpVerbTRACE
HttpVerbTRACK (Const) => httpVerbTRACK
HttpVerbUnknown (Const) => httpVerbUnknown
HttpVerbUNLOCK (Const) => httpVerbUNLOCK
HttpVerbUnparsed (Const) => httpVerbUnparsed
ICCOMPRESS (Object) => TICCOMPRESS
ICDECOMPRESS (Object) => TICDECOMPRESS
ICDRAW (Object) => TICDRAW
ICDRAWBEGIN (Object) => TICDRAWBEGIN
ICINFO (Object) => TICINFO
ICOPEN (Object) => TICOPEN
IdleConnectionTimeout (Const) => idleConnectionTimeout
IdleResiliency (Const) => idleResiliency
IdleShutdown (Const) => idleShutdown
IfOperStatusDormant (Const) => ifOperStatusDormant
IfOperStatusDown (Const) => ifOperStatusDown
IfOperStatusLowerLayerDown (Const) => ifOperStatusLowerLayerDown
IfOperStatusNotPresent (Const) => ifOperStatusNotPresent
IfOperStatusTesting (Const) => ifOperStatusTesting
IfOperStatusUnknown (Const) => ifOperStatusUnknown
IfOperStatusUp (Const) => ifOperStatusUp
IgnoreError (Const) => ignoreError
IID__SearchAssistantEvents (Const) => IID_SearchAssistantEvents
ImageCodecFlagsBlockingDecode (Const) => imageCodecFlagsBlockingDecode
ImageCodecFlagsBuiltin (Const) => imageCodecFlagsBuiltin
ImageCodecFlagsDecoder (Const) => imageCodecFlagsDecoder
ImageCodecFlagsEncoder (Const) => imageCodecFlagsEncoder
ImageCodecFlagsSeekableEncode (Const) => imageCodecFlagsSeekableEncode
ImageCodecFlagsSupportBitmap (Const) => imageCodecFlagsSupportBitmap
ImageCodecFlagsSupportVector (Const) => imageCodecFlagsSupportVector
ImageCodecFlagsSystem (Const) => imageCodecFlagsSystem
ImageCodecFlagsUser (Const) => imageCodecFlagsUser
ImageFlagsCaching (Const) => imageFlagsCaching
ImageFlagsColorSpaceCMYK (Const) => imageFlagsColorSpaceCMYK
ImageFlagsColorSpaceGRAY (Const) => imageFlagsColorSpaceGRAY
ImageFlagsColorSpaceRGB (Const) => imageFlagsColorSpaceRGB
ImageFlagsColorSpaceYCBCR (Const) => imageFlagsColorSpaceYCBCR
ImageFlagsColorSpaceYCCK (Const) => imageFlagsColorSpaceYCCK
ImageFlagsHasAlpha (Const) => imageFlagsHasAlpha
ImageFlagsHasRealDPI (Const) => imageFlagsHasRealDPI
ImageFlagsHasRealPixelSize (Const) => imageFlagsHasRealPixelSize
ImageFlagsHasTranslucent (Const) => imageFlagsHasTranslucent
ImageFlagsNone (Const) => imageFlagsNone
ImageFlagsPartiallyScalable (Const) => imageFlagsPartiallyScalable
ImageFlagsReadOnly (Const) => imageFlagsReadOnly
ImageFlagsScalable (Const) => imageFlagsScalable
ImageLockModeRead (Const) => imageLockModeRead
ImageLockModeUserInputBuf (Const) => imageLockModeUserInputBuf
ImageLockModeWrite (Const) => imageLockModeWrite
ImageTypeBitmap (Const) => imageTypeBitmap
ImageTypeMetafile (Const) => imageTypeMetafile
ImageTypeUnknown (Const) => imageTypeUnknown
IncludeModuleCallback (Const) => includeModuleCallback
IncludeThreadCallback (Const) => includeThreadCallback
IncludeVmRegionCallback (Const) => includeVmRegionCallback
INITCOMMONCONTROLSEX (Object) => TINITCOMMONCONTROLSEX
InsufficientBuffer (Const) => insufficientBuffer
Interactive (Const) => interactive
INTERFACE_INFO (Object) => TINTERFACE_INFO
InterpolationModeBicubic (Const) => interpolationModeBicubic
InterpolationModeBilinear (Const) => interpolationModeBilinear
InterpolationModeDefault (Const) => interpolationModeDefault
InterpolationModeHighQuality (Const) => interpolationModeHighQuality
InterpolationModeHighQualityBicubic (Const) => interpolationModeHighQualityBicubic
InterpolationModeHighQualityBilinear (Const) => interpolationModeHighQualityBilinear
InterpolationModeInvalid (Const) => interpolationModeInvalid
InterpolationModeLowQuality (Const) => interpolationModeLowQuality
InterpolationModeNearestNeighbor (Const) => interpolationModeNearestNeighbor
InvalidBucketParamIndex (Const) => invalidBucketParamIndex
InvalidParameter (Const) => invalidParameter
IoFinishCallback (Const) => ioFinishCallback
IoPriorityHintLow (Const) => ioPriorityHintLow
IoPriorityHintNormal (Const) => ioPriorityHintNormal
IoPriorityHintVeryLow (Const) => ioPriorityHintVeryLow
IoStartCallback (Const) => ioStartCallback
IoWriteAllCallback (Const) => ioWriteAllCallback
IpDadStateDeprecated (Const) => ipDadStateDeprecated
IpDadStateDuplicate (Const) => ipDadStateDuplicate
IpDadStateInvalid (Const) => ipDadStateInvalid
IpDadStatePreferred (Const) => ipDadStatePreferred
IpDadStateTentative (Const) => ipDadStateTentative
IpPrefixOriginDhcp (Const) => ipPrefixOriginDhcp
IpPrefixOriginManual (Const) => ipPrefixOriginManual
IpPrefixOriginOther (Const) => ipPrefixOriginOther
IpPrefixOriginRouterAdvertisement (Const) => ipPrefixOriginRouterAdvertisement
IpPrefixOriginUnchanged (Const) => ipPrefixOriginUnchanged
IpPrefixOriginWellKnown (Const) => ipPrefixOriginWellKnown
IpSuffixOriginDhcp (Const) => ipSuffixOriginDhcp
IpSuffixOriginLinkLayerAddress (Const) => ipSuffixOriginLinkLayerAddress
IpSuffixOriginManual (Const) => ipSuffixOriginManual
IpSuffixOriginOther (Const) => ipSuffixOriginOther
IpSuffixOriginRandom (Const) => ipSuffixOriginRandom
IpSuffixOriginUnchanged (Const) => ipSuffixOriginUnchanged
IpSuffixOriginWellKnown (Const) => ipSuffixOriginWellKnown
ItemDataPositionAfterBits (Const) => itemDataPositionAfterBits
ItemDataPositionAfterHeader (Const) => itemDataPositionAfterHeader
ItemDataPositionAfterPalette (Const) => itemDataPositionAfterPalette
JobObjectAssociateCompletionPortInformation (Const) => jobObjectAssociateCompletionPortInformation
JobObjectBasicAccountingInformation (Const) => jobObjectBasicAccountingInformation
JobObjectBasicAndIoAccountingInformation (Const) => jobObjectBasicAndIoAccountingInformation
JobObjectBasicLimitInformation (Const) => jobObjectBasicLimitInformation
JobObjectBasicProcessIdList (Const) => jobObjectBasicProcessIdList
JobObjectBasicUIRestrictions (Const) => jobObjectBasicUIRestrictions
JobObjectCompletionCounter (Const) => jobObjectCompletionCounter
JobObjectCompletionFilter (Const) => jobObjectCompletionFilter
JobObjectCpuRateControlInformation (Const) => jobObjectCpuRateControlInformation
JobObjectEndOfJobTimeInformation (Const) => jobObjectEndOfJobTimeInformation
JobObjectExtendedLimitInformation (Const) => jobObjectExtendedLimitInformation
JobObjectGroupInformation (Const) => jobObjectGroupInformation
JobObjectGroupInformationEx (Const) => jobObjectGroupInformationEx
JobObjectJobSetInformation (Const) => jobObjectJobSetInformation
JobObjectLimitViolationInformation (Const) => jobObjectLimitViolationInformation
JobObjectNotificationLimitInformation (Const) => jobObjectNotificationLimitInformation
JobObjectReserved1Information (Const) => jobObjectReserved1Information
JobObjectReserved2Information (Const) => jobObjectReserved2Information
JobObjectReserved3Information (Const) => jobObjectReserved3Information
JobObjectReserved4Information (Const) => jobObjectReserved4Information
JobObjectReserved5Information (Const) => jobObjectReserved5Information
JobObjectReserved6Information (Const) => jobObjectReserved6Information
JobObjectReserved7Information (Const) => jobObjectReserved7Information
JobObjectReserved8Information (Const) => jobObjectReserved8Information
JobObjectSecurityLimitInformation (Const) => jobObjectSecurityLimitInformation
KeepPrefetchedData (Const) => keepPrefetchedData
KeepReadData (Const) => keepReadData
KerbAddBindingCacheEntryMessage (Const) => kerbAddBindingCacheEntryMessage
KerbAddExtraCredentialsMessage (Const) => kerbAddExtraCredentialsMessage
KerbCertificateLogon (Const) => kerbCertificateLogon
KerbCertificateS4ULogon (Const) => kerbCertificateS4ULogon
KerbCertificateUnlockLogon (Const) => kerbCertificateUnlockLogon
KerbChangeMachinePasswordMessage (Const) => kerbChangeMachinePasswordMessage
KerbChangePasswordMessage (Const) => kerbChangePasswordMessage
KerbDebugRequestMessage (Const) => kerbDebugRequestMessage
KerbDecryptDataMessage (Const) => kerbDecryptDataMessage
KerbInteractiveLogon (Const) => kerbInteractiveLogon
KerbInteractiveProfile (Const) => kerbInteractiveProfile
KerbProxyLogon (Const) => kerbProxyLogon
KerbPurgeTicketCacheExMessage (Const) => kerbPurgeTicketCacheExMessage
KerbPurgeTicketCacheMessage (Const) => kerbPurgeTicketCacheMessage
KerbQuerySupplementalCredentialsMessage (Const) => kerbQuerySupplementalCredentialsMessage
KerbQueryTicketCacheEx2Message (Const) => kerbQueryTicketCacheEx2Message
KerbQueryTicketCacheExMessage (Const) => kerbQueryTicketCacheExMessage
KerbQueryTicketCacheMessage (Const) => kerbQueryTicketCacheMessage
KerbRefreshSmartcardCredentialsMessage (Const) => kerbRefreshSmartcardCredentialsMessage
KerbRetrieveEncodedTicketMessage (Const) => kerbRetrieveEncodedTicketMessage
KerbRetrieveTicketMessage (Const) => kerbRetrieveTicketMessage
KerbS4ULogon (Const) => kerbS4ULogon
KerbSetPasswordExMessage (Const) => kerbSetPasswordExMessage
KerbSetPasswordMessage (Const) => kerbSetPasswordMessage
KerbSmartCardLogon (Const) => kerbSmartCardLogon
KerbSmartCardProfile (Const) => kerbSmartCardProfile
KerbSmartCardUnlockLogon (Const) => kerbSmartCardUnlockLogon
KerbTicketLogon (Const) => kerbTicketLogon
KerbTicketProfile (Const) => kerbTicketProfile
KerbTicketUnlockLogon (Const) => kerbTicketUnlockLogon
KerbTransferCredentialsMessage (Const) => kerbTransferCredentialsMessage
KerbUpdateAddressesMessage (Const) => kerbUpdateAddressesMessage
KerbVerifyCredentialsMessage (Const) => kerbVerifyCredentialsMessage
KerbVerifyPacMessage (Const) => kerbVerifyPacMessage
KerbWorkstationUnlockLogon (Const) => kerbWorkstationUnlockLogon
KernelMinidumpStatusCallback (Const) => kernelMinidumpStatusCallback
LastReservedStream (Const) => lastReservedStream
LastResumePerformance (Const) => lastResumePerformance
LastSleepTime (Const) => lastSleepTime
LastWakeTime (Const) => lastWakeTime
LibraryApplication (Const) => libraryApplication
LinearGradientModeBackwardDiagonal (Const) => linearGradientModeBackwardDiagonal
LinearGradientModeForwardDiagonal (Const) => linearGradientModeForwardDiagonal
LinearGradientModeHorizontal (Const) => linearGradientModeHorizontal
LinearGradientModeVertical (Const) => linearGradientModeVertical
LineCap (Type) => GpLineCap
LineCapArrowAnchor (Const) => lineCapArrowAnchor
LineCapCustom (Const) => lineCapCustom
LineCapDiamondAnchor (Const) => lineCapDiamondAnchor
LineCapFlat (Const) => lineCapFlat
LineCapNoAnchor (Const) => lineCapNoAnchor
LineCapRound (Const) => lineCapRound
LineCapRoundAnchor (Const) => lineCapRoundAnchor
LineCapSquare (Const) => lineCapSquare
LineCapSquareAnchor (Const) => lineCapSquareAnchor
LineCapTriangle (Const) => lineCapTriangle
LineJoin (Type) => GpLineJoin
LineJoinBevel (Const) => lineJoinBevel
LineJoinMiter (Const) => lineJoinMiter
LineJoinMiterClipped (Const) => lineJoinMiterClipped
LineJoinRound (Const) => lineJoinRound
LinkLocalAlwaysOff (Const) => linkLocalAlwaysOff
LinkLocalAlwaysOn (Const) => linkLocalAlwaysOn
LinkLocalDelayed (Const) => linkLocalDelayed
LinkLocalUnchanged (Const) => linkLocalUnchanged
LogicalProcessorIdling (Const) => logicalProcessorIdling
LogSevError (Const) => logSevError
LogSevFatalError (Const) => logSevFatalError
LogSevInformation (Const) => logSevInformation
LogSevMaximum (Const) => logSevMaximum
LogSevWarning (Const) => logSevWarning
LowMemoryResourceNotification (Const) => lowMemoryResourceNotification
LPINTERFACE_INFO (Type) => LPTINTERFACE_INFO
MandatoryLevelCount (Const) => mandatoryLevelCount
MandatoryLevelHigh (Const) => mandatoryLevelHigh
MandatoryLevelLow (Const) => mandatoryLevelLow
MandatoryLevelMedium (Const) => mandatoryLevelMedium
MandatoryLevelSecureProcess (Const) => mandatoryLevelSecureProcess
MandatoryLevelSystem (Const) => mandatoryLevelSystem
MandatoryLevelUntrusted (Const) => mandatoryLevelUntrusted
MatrixOrder (Type) => GpMatrixOrder
MatrixOrderAppend (Const) => matrixOrderAppend
MatrixOrderPrepend (Const) => matrixOrderPrepend
MaxActivationContextInfoClass (Const) => maxActivationContextInfoClass
MaxCacheResponseSize (Const) => maxCacheResponseSize
MaxClrEvent (Const) => maxClrEvent
MaxClrFailure (Const) => maxClrFailure
MaxClrOperation (Const) => maxClrOperation
MaxHardwareCounterType (Const) => maxHardwareCounterType
MaximumFileIdType (Const) => maximumFileIdType
MaximumFileInfoByHandleClass (Const) => maximumFileInfoByHandleClass
MaximumIoPriorityHintType (Const) => maximumIoPriorityHintType
MaximumWaitReason (Const) => maximumWaitReason
MaxJobObjectInfoClass (Const) => maxJobObjectInfoClass
MaxNumberOfEEInfoParams (Const) => maxNumberOfEEInfoParams
MaxPolicyAction (Const) => maxPolicyAction
MaxProcessInfoClass (Const) => maxProcessInfoClass
MaxProcessMitigationPolicy (Const) => maxProcessMitigationPolicy
MaxTokenInfoClass (Const) => maxTokenInfoClass
MediaConnectStateConnected (Const) => mediaConnectStateConnected
MediaConnectStateDisconnected (Const) => mediaConnectStateDisconnected
MediaConnectStateUnknown (Const) => mediaConnectStateUnknown
MediaDuplexStateFull (Const) => mediaDuplexStateFull
MediaDuplexStateHalf (Const) => mediaDuplexStateHalf
MediaDuplexStateUnknown (Const) => mediaDuplexStateUnknown
MediumChangerClassGuid (Const) => mediumChangerClassGuid
Memory64ListStream (Const) => memory64ListStream
MemoryCallback (Const) => memoryCallback
MemoryInfoListStream (Const) => memoryInfoListStream
MemoryListStream (Const) => memoryListStream
MetafileFrameUnitDocument (Const) => metafileFrameUnitDocument
MetafileFrameUnitGdi (Const) => metafileFrameUnitGdi
MetafileFrameUnitInch (Const) => metafileFrameUnitInch
MetafileFrameUnitMillimeter (Const) => metafileFrameUnitMillimeter
MetafileFrameUnitPixel (Const) => metafileFrameUnitPixel
MetafileFrameUnitPoint (Const) => metafileFrameUnitPoint
MetafileTypeEmf (Const) => metafileTypeEmf
MetafileTypeEmfPlusDual (Const) => metafileTypeEmfPlusDual
MetafileTypeEmfPlusOnly (Const) => metafileTypeEmfPlusOnly
MetafileTypeInvalid (Const) => metafileTypeInvalid
MetafileTypeWmf (Const) => metafileTypeWmf
MetafileTypeWmfPlaceable (Const) => metafileTypeWmfPlaceable
MibAddInstance (Const) => mibAddInstance
MibDeleteInstance (Const) => mibDeleteInstance
MibIfTableNormal (Const) => mibIfTableNormal
MibIfTableRaw (Const) => mibIfTableRaw
MibInitialNotification (Const) => mibInitialNotification
MibParameterNotification (Const) => mibParameterNotification
MIDIPROPTEMPO (Object) => TMIDIPROPTEMPO
MIDIPROPTIMEDIV (Object) => TMIDIPROPTIMEDIV
MilMatrix3x2D (Object) => MIL_MATRIX3X2D
MiniDumpFilterMemory (Const) => miniDumpFilterMemory
MiniDumpFilterModulePaths (Const) => miniDumpFilterModulePaths
MiniDumpIgnoreInaccessibleMemory (Const) => miniDumpIgnoreInaccessibleMemory
MiniDumpNormal (Const) => miniDumpNormal
MiniDumpScanMemory (Const) => miniDumpScanMemory
MiniDumpWithCodeSegs (Const) => miniDumpWithCodeSegs
MiniDumpWithDataSegs (Const) => miniDumpWithDataSegs
MiniDumpWithFullAuxiliaryState (Const) => miniDumpWithFullAuxiliaryState
MiniDumpWithFullMemory (Const) => miniDumpWithFullMemory
MiniDumpWithFullMemoryInfo (Const) => miniDumpWithFullMemoryInfo
MiniDumpWithHandleData (Const) => miniDumpWithHandleData
MiniDumpWithIndirectlyReferencedMemory (Const) => miniDumpWithIndirectlyReferencedMemory
MiniDumpWithoutAuxiliaryState (Const) => miniDumpWithoutAuxiliaryState
MiniDumpWithoutOptionalData (Const) => miniDumpWithoutOptionalData
MiniDumpWithPrivateReadWriteMemory (Const) => miniDumpWithPrivateReadWriteMemory
MiniDumpWithPrivateWriteCopyMemory (Const) => miniDumpWithPrivateWriteCopyMemory
MiniDumpWithProcessThreadData (Const) => miniDumpWithProcessThreadData
MiniDumpWithThreadInfo (Const) => miniDumpWithThreadInfo
MiniDumpWithTokenInformation (Const) => miniDumpWithTokenInformation
MiniDumpWithUnloadedModules (Const) => miniDumpWithUnloadedModules
MiniQic (Const) => miniQic
MiniSecondaryWithoutPowerInfo (Const) => miniSecondaryWithoutPowerInfo
MiscInfoStream (Const) => miscInfoStream
MODULE_WRITE_FLAGS (Type) => TMODULE_WRITE_FLAGS
ModuleCallback (Const) => moduleCallback
ModuleListStream (Const) => moduleListStream
ModuleReferencedByMemory (Const) => moduleReferencedByMemory
ModuleWriteCodeSegs (Const) => moduleWriteCodeSegs
ModuleWriteCvRecord (Const) => moduleWriteCvRecord
ModuleWriteDataSeg (Const) => moduleWriteDataSeg
ModuleWriteMiscRecord (Const) => moduleWriteMiscRecord
ModuleWriteModule (Const) => moduleWriteModule
ModuleWriteTlsData (Const) => moduleWriteTlsData
MonitorCapabilities (Const) => monitorCapabilities
MonitorInvocation (Const) => monitorInvocation
MonitorRequestReasonAcDcDisplayBurst (Const) => monitorRequestReasonAcDcDisplayBurst
MonitorRequestReasonFullWake (Const) => monitorRequestReasonFullWake
MonitorRequestReasonIdleTimeout (Const) => monitorRequestReasonIdleTimeout
MonitorRequestReasonMax (Const) => monitorRequestReasonMax
MonitorRequestReasonPolicyChange (Const) => monitorRequestReasonPolicyChange
MonitorRequestReasonPoSetSystemState (Const) => monitorRequestReasonPoSetSystemState
MonitorRequestReasonPowerButton (Const) => monitorRequestReasonPowerButton
MonitorRequestReasonRemoteConnection (Const) => monitorRequestReasonRemoteConnection
MonitorRequestReasonScMonitorpower (Const) => monitorRequestReasonScMonitorpower
MonitorRequestReasonScreenOffRequest (Const) => monitorRequestReasonScreenOffRequest
MonitorRequestReasonSessionUnlock (Const) => monitorRequestReasonSessionUnlock
MonitorRequestReasonSetThreadExecutionState (Const) => monitorRequestReasonSetThreadExecutionState
MonitorRequestReasonUnknown (Const) => monitorRequestReasonUnknown
MonitorRequestReasonUserDisplayBurst (Const) => monitorRequestReasonUserDisplayBurst
MonitorRequestReasonUserInput (Const) => monitorRequestReasonUserInput
MsaInfoCanInstall (Const) => msaInfoCanInstall
MsaInfoCannotInstall (Const) => msaInfoCannotInstall
MsaInfoInstalled (Const) => msaInfoInstalled
MsaInfoNotExist (Const) => msaInfoNotExist
MsaInfoNotService (Const) => msaInfoNotService
MSV1_0_INTERACTIVE_LOGON (Object) => TMSV1_0_INTERACTIVE_LOGON
MSV1_0_INTERACTIVE_PROFILE (Object) => TMSV1_0_INTERACTIVE_PROFILE
MSV1_0_LM20_LOGON (Object) => TMSV1_0_LM20_LOGON
MSV1_0_LM20_LOGON_PROFILE (Object) => TMSV1_0_LM20_LOGON_PROFILE
MSV1_0_SUBAUTH_LOGON (Object) => TMSV1_0_SUBAUTH_LOGON
MsvAvDnsComputerName (Const) => msvAvDnsComputerName
MsvAvDnsDomainName (Const) => msvAvDnsDomainName
MsvAvDnsTreeName (Const) => msvAvDnsTreeName
MsvAvEOL (Const) => msvAvEOL
MsvAvFlags (Const) => msvAvFlags
MsvAvNbComputerName (Const) => msvAvNbComputerName
MsvAvNbDomainName (Const) => msvAvNbDomainName
NameCanonical (Const) => nameCanonical
NameCanonicalEx (Const) => nameCanonicalEx
NameDisplay (Const) => nameDisplay
NameDnsDomain (Const) => nameDnsDomain
NameFullyQualifiedDN (Const) => nameFullyQualifiedDN
NameGivenName (Const) => nameGivenName
NameSamCompatible (Const) => nameSamCompatible
NameServicePrincipal (Const) => nameServicePrincipal
NameSurname (Const) => nameSurname
NameUniqueId (Const) => nameUniqueId
NameUnknown (Const) => nameUnknown
NameUserPrincipal (Const) => nameUserPrincipal
NdisARPHeaderFieldMaximum (Const) => ndisARPHeaderFieldMaximum
NdisARPHeaderFieldOperation (Const) => ndisARPHeaderFieldOperation
NdisARPHeaderFieldSPA (Const) => ndisARPHeaderFieldSPA
NdisARPHeaderFieldTPA (Const) => ndisARPHeaderFieldTPA
NdisARPHeaderFieldUndefined (Const) => ndisARPHeaderFieldUndefined
NdisDefinitelyNetworkChange (Const) => ndisDefinitelyNetworkChange
NdisDeviceStateD0 (Const) => ndisDeviceStateD0
NdisDeviceStateD1 (Const) => ndisDeviceStateD1
NdisDeviceStateD2 (Const) => ndisDeviceStateD2
NdisDeviceStateD3 (Const) => ndisDeviceStateD3
NdisDeviceStateMaximum (Const) => ndisDeviceStateMaximum
NdisDeviceStateUnspecified (Const) => ndisDeviceStateUnspecified
NdisFddiRingDetect (Const) => ndisFddiRingDetect
NdisFddiRingDirected (Const) => ndisFddiRingDirected
NdisFddiRingIsolated (Const) => ndisFddiRingIsolated
NdisFddiRingNonOperational (Const) => ndisFddiRingNonOperational
NdisFddiRingNonOperationalDup (Const) => ndisFddiRingNonOperationalDup
NdisFddiRingOperational (Const) => ndisFddiRingOperational
NdisFddiRingOperationalDup (Const) => ndisFddiRingOperationalDup
NdisFddiRingTrace (Const) => ndisFddiRingTrace
NdisFddiStateActive (Const) => ndisFddiStateActive
NdisFddiStateBreak (Const) => ndisFddiStateBreak
NdisFddiStateConnect (Const) => ndisFddiStateConnect
NdisFddiStateJoin (Const) => ndisFddiStateJoin
NdisFddiStateMaintenance (Const) => ndisFddiStateMaintenance
NdisFddiStateNext (Const) => ndisFddiStateNext
NdisFddiStateOff (Const) => ndisFddiStateOff
NdisFddiStateSignal (Const) => ndisFddiStateSignal
NdisFddiStateTrace (Const) => ndisFddiStateTrace
NdisFddiStateVerify (Const) => ndisFddiStateVerify
NdisFddiTypeCWrapA (Const) => ndisFddiTypeCWrapA
NdisFddiTypeCWrapB (Const) => ndisFddiTypeCWrapB
NdisFddiTypeCWrapS (Const) => ndisFddiTypeCWrapS
NdisFddiTypeIsolated (Const) => ndisFddiTypeIsolated
NdisFddiTypeLocalA (Const) => ndisFddiTypeLocalA
NdisFddiTypeLocalAB (Const) => ndisFddiTypeLocalAB
NdisFddiTypeLocalB (Const) => ndisFddiTypeLocalB
NdisFddiTypeLocalS (Const) => ndisFddiTypeLocalS
NdisFddiTypeThrough (Const) => ndisFddiTypeThrough
NdisFddiTypeWrapA (Const) => ndisFddiTypeWrapA
NdisFddiTypeWrapAB (Const) => ndisFddiTypeWrapAB
NdisFddiTypeWrapB (Const) => ndisFddiTypeWrapB
NdisFddiTypeWrapS (Const) => ndisFddiTypeWrapS
NdisFrameHeaderArp (Const) => ndisFrameHeaderArp
NdisFrameHeaderIPv4 (Const) => ndisFrameHeaderIPv4
NdisFrameHeaderIPv6 (Const) => ndisFrameHeaderIPv6
NdisFrameHeaderMac (Const) => ndisFrameHeaderMac
NdisFrameHeaderMaximum (Const) => ndisFrameHeaderMaximum
NdisFrameHeaderUdp (Const) => ndisFrameHeaderUdp
NdisFrameHeaderUndefined (Const) => ndisFrameHeaderUndefined
NdisHardwareStatusClosing (Const) => ndisHardwareStatusClosing
NdisHardwareStatusInitializing (Const) => ndisHardwareStatusInitializing
NdisHardwareStatusNotReady (Const) => ndisHardwareStatusNotReady
NdisHardwareStatusReady (Const) => ndisHardwareStatusReady
NdisHardwareStatusReset (Const) => ndisHardwareStatusReset
NdisHashFunctionReserved1 (Const) => ndisHashFunctionReserved1
NdisHashFunctionReserved2 (Const) => ndisHashFunctionReserved2
NdisHashFunctionReserved3 (Const) => ndisHashFunctionReserved3
NdisHashFunctionToeplitz (Const) => ndisHashFunctionToeplitz
NdisHypervisorPartitionMsHvChild (Const) => ndisHypervisorPartitionMsHvChild
NdisHypervisorPartitionTypeMax (Const) => ndisHypervisorPartitionTypeMax
NdisHypervisorPartitionTypeMsHvParent (Const) => ndisHypervisorPartitionTypeMsHvParent
NdisHypervisorPartitionTypeUnknown (Const) => ndisHypervisorPartitionTypeUnknown
NdisInterruptModerationDisabled (Const) => ndisInterruptModerationDisabled
NdisInterruptModerationEnabled (Const) => ndisInterruptModerationEnabled
NdisInterruptModerationNotSupported (Const) => ndisInterruptModerationNotSupported
NdisInterruptModerationUnknown (Const) => ndisInterruptModerationUnknown
NdisIPv4HeaderFieldMaximum (Const) => ndisIPv4HeaderFieldMaximum
NdisIPv4HeaderFieldProtocol (Const) => ndisIPv4HeaderFieldProtocol
NdisIPv4HeaderFieldUndefined (Const) => ndisIPv4HeaderFieldUndefined
NdisIPv6HeaderFieldMaximum (Const) => ndisIPv6HeaderFieldMaximum
NdisIPv6HeaderFieldProtocol (Const) => ndisIPv6HeaderFieldProtocol
NdisIPv6HeaderFieldUndefined (Const) => ndisIPv6HeaderFieldUndefined
NdisMacHeaderFieldDestinationAddress (Const) => ndisMacHeaderFieldDestinationAddress
NdisMacHeaderFieldMaximum (Const) => ndisMacHeaderFieldMaximum
NdisMacHeaderFieldPacketType (Const) => ndisMacHeaderFieldPacketType
NdisMacHeaderFieldPriority (Const) => ndisMacHeaderFieldPriority
NdisMacHeaderFieldProtocol (Const) => ndisMacHeaderFieldProtocol
NdisMacHeaderFieldSourceAddress (Const) => ndisMacHeaderFieldSourceAddress
NdisMacHeaderFieldUndefined (Const) => ndisMacHeaderFieldUndefined
NdisMacHeaderFieldVlanId (Const) => ndisMacHeaderFieldVlanId
NdisMacPacketTypeBroadcast (Const) => ndisMacPacketTypeBroadcast
NdisMacPacketTypeMaximum (Const) => ndisMacPacketTypeMaximum
NdisMacPacketTypeMulticast (Const) => ndisMacPacketTypeMulticast
NdisMacPacketTypeUndefined (Const) => ndisMacPacketTypeUndefined
NdisMacPacketTypeUnicast (Const) => ndisMacPacketTypeUnicast
NdisMediaStateConnected (Const) => ndisMediaStateConnected
NdisMediaStateDisconnected (Const) => ndisMediaStateDisconnected
NdisMedium1394 (Const) => ndisMedium1394
NdisMediumArcnetRaw (Const) => ndisMediumArcnetRaw
NdisMediumAtm (Const) => ndisMediumAtm
NdisMediumBpc (Const) => ndisMediumBpc
NdisMediumCoWan (Const) => ndisMediumCoWan
NdisMediumDix (Const) => ndisMediumDix
NdisMediumFddi (Const) => ndisMediumFddi
NdisMediumInfiniBand (Const) => ndisMediumInfiniBand
NdisMediumIP (Const) => ndisMediumIP
NdisMediumIrda (Const) => ndisMediumIrda
NdisMediumLocalTalk (Const) => ndisMediumLocalTalk
NdisMediumLoopback (Const) => ndisMediumLoopback
NdisMediumMax (Const) => ndisMediumMax
NdisMediumTunnel (Const) => ndisMediumTunnel
NdisMediumWan (Const) => ndisMediumWan
NdisMediumWiMAX (Const) => ndisMediumWiMAX
NdisMediumWirelessWan (Const) => ndisMediumWirelessWan
NdisNetworkChangeFromMediaConnect (Const) => ndisNetworkChangeFromMediaConnect
NdisNetworkChangeMax (Const) => ndisNetworkChangeMax
NdisNicSwitchTypeExternal (Const) => ndisNicSwitchTypeExternal
NdisNicSwitchTypeMax (Const) => ndisNicSwitchTypeMax
NdisNicSwitchTypeUnspecified (Const) => ndisNicSwitchTypeUnspecified
NdisNicSwitchVPortInterruptModerationAdaptive (Const) => ndisNicSwitchVPortInterruptModerationAdaptive
NdisNicSwitchVPortInterruptModerationHigh (Const) => ndisNicSwitchVPortInterruptModerationHigh
NdisNicSwitchVPortInterruptModerationLow (Const) => ndisNicSwitchVPortInterruptModerationLow
NdisNicSwitchVPortInterruptModerationMedium (Const) => ndisNicSwitchVPortInterruptModerationMedium
NdisNicSwitchVPortInterruptModerationOff (Const) => ndisNicSwitchVPortInterruptModerationOff
NdisNicSwitchVPortInterruptModerationUndefined (Const) => ndisNicSwitchVPortInterruptModerationUndefined
NdisNicSwitchVPortStateActivated (Const) => ndisNicSwitchVPortStateActivated
NdisNicSwitchVPortStateDeactivated (Const) => ndisNicSwitchVPortStateDeactivated
NdisNicSwitchVPortStateMaximum (Const) => ndisNicSwitchVPortStateMaximum
NdisNicSwitchVPortStateUndefined (Const) => ndisNicSwitchVPortStateUndefined
NdisPauseFunctionsReceiveOnly (Const) => ndisPauseFunctionsReceiveOnly
NdisPauseFunctionsSendAndReceive (Const) => ndisPauseFunctionsSendAndReceive
NdisPauseFunctionsSendOnly (Const) => ndisPauseFunctionsSendOnly
NdisPauseFunctionsUnknown (Const) => ndisPauseFunctionsUnknown
NdisPauseFunctionsUnsupported (Const) => ndisPauseFunctionsUnsupported
NdisPhysicalMedium1394 (Const) => ndisPhysicalMedium1394
NdisPhysicalMediumBluetooth (Const) => ndisPhysicalMediumBluetooth
NdisPhysicalMediumCableModem (Const) => ndisPhysicalMediumCableModem
NdisPhysicalMediumDSL (Const) => ndisPhysicalMediumDSL
NdisPhysicalMediumFibreChannel (Const) => ndisPhysicalMediumFibreChannel
NdisPhysicalMediumInfiniband (Const) => ndisPhysicalMediumInfiniband
NdisPhysicalMediumIrda (Const) => ndisPhysicalMediumIrda
NdisPhysicalMediumMax (Const) => ndisPhysicalMediumMax
NdisPhysicalMediumOther (Const) => ndisPhysicalMediumOther
NdisPhysicalMediumPhoneLine (Const) => ndisPhysicalMediumPhoneLine
NdisPhysicalMediumPowerLine (Const) => ndisPhysicalMediumPowerLine
NdisPhysicalMediumUnspecified (Const) => ndisPhysicalMediumUnspecified
NdisPhysicalMediumUWB (Const) => ndisPhysicalMediumUWB
NdisPhysicalMediumWiMax (Const) => ndisPhysicalMediumWiMax
NdisPhysicalMediumWiredCoWan (Const) => ndisPhysicalMediumWiredCoWan
NdisPhysicalMediumWiredWAN (Const) => ndisPhysicalMediumWiredWAN
NdisPhysicalMediumWirelessLan (Const) => ndisPhysicalMediumWirelessLan
NdisPhysicalMediumWirelessWan (Const) => ndisPhysicalMediumWirelessWan
NdisPMAdminConfigActive (Const) => ndisPMAdminConfigActive
NdisPMAdminConfigDisabled (Const) => ndisPMAdminConfigDisabled
NdisPMAdminConfigEnabled (Const) => ndisPMAdminConfigEnabled
NdisPMAdminConfigInactive (Const) => ndisPMAdminConfigInactive
NdisPMAdminConfigUnspecified (Const) => ndisPMAdminConfigUnspecified
NdisPMAdminConfigUnsupported (Const) => ndisPMAdminConfigUnsupported
NdisPMProtocolOffload80211RSNRekey (Const) => ndisPMProtocolOffload80211RSNRekey
NdisPMProtocolOffloadIdIPv4ARP (Const) => ndisPMProtocolOffloadIdIPv4ARP
NdisPMProtocolOffloadIdIPv6NS (Const) => ndisPMProtocolOffloadIdIPv6NS
NdisPMProtocolOffloadIdMaximum (Const) => ndisPMProtocolOffloadIdMaximum
NdisPMProtocolOffloadIdUnspecified (Const) => ndisPMProtocolOffloadIdUnspecified
NdisPMWoLPacketBitmapPattern (Const) => ndisPMWoLPacketBitmapPattern
NdisPMWoLPacketEapolRequestIdMessage (Const) => ndisPMWoLPacketEapolRequestIdMessage
NdisPMWoLPacketIPv4TcpSyn (Const) => ndisPMWoLPacketIPv4TcpSyn
NdisPMWoLPacketIPv6TcpSyn (Const) => ndisPMWoLPacketIPv6TcpSyn
NdisPMWoLPacketMagicPacket (Const) => ndisPMWoLPacketMagicPacket
NdisPMWoLPacketMaximum (Const) => ndisPMWoLPacketMaximum
NdisPMWoLPacketUnspecified (Const) => ndisPMWoLPacketUnspecified
NdisPortAuthorizationUnknown (Const) => ndisPortAuthorizationUnknown
NdisPortAuthorized (Const) => ndisPortAuthorized
NdisPortControlStateControlled (Const) => ndisPortControlStateControlled
NdisPortControlStateUncontrolled (Const) => ndisPortControlStateUncontrolled
NdisPortControlStateUnknown (Const) => ndisPortControlStateUnknown
NdisPortReauthorizing (Const) => ndisPortReauthorizing
NdisPortType8021xSupplicant (Const) => ndisPortType8021xSupplicant
NdisPortTypeBridge (Const) => ndisPortTypeBridge
NdisPortTypeMax (Const) => ndisPortTypeMax
NdisPortTypeNdisImPlatform (Const) => ndisPortTypeNdisImPlatform
NdisPortTypeRasConnection (Const) => ndisPortTypeRasConnection
NdisPortTypeUndefined (Const) => ndisPortTypeUndefined
NdisPortUnauthorized (Const) => ndisPortUnauthorized
NdisPossibleNetworkChange (Const) => ndisPossibleNetworkChange
NdisProcessorVendorAuthenticAMD (Const) => ndisProcessorVendorAuthenticAMD
NdisProcessorVendorGenuineIntel (Const) => ndisProcessorVendorGenuineIntel
NdisProcessorVendorGenuinIntel (Const) => ndisProcessorVendorGenuinIntel
NdisProcessorVendorUnknown (Const) => ndisProcessorVendorUnknown
NdisReceiveFilterTestEqual (Const) => ndisReceiveFilterTestEqual
NdisReceiveFilterTestMaskEqual (Const) => ndisReceiveFilterTestMaskEqual
NdisReceiveFilterTestMaximum (Const) => ndisReceiveFilterTestMaximum
NdisReceiveFilterTestNotEqual (Const) => ndisReceiveFilterTestNotEqual
NdisReceiveFilterTestUndefined (Const) => ndisReceiveFilterTestUndefined
NdisReceiveFilterTypeMaximum (Const) => ndisReceiveFilterTypeMaximum
NdisReceiveFilterTypePacketCoalescing (Const) => ndisReceiveFilterTypePacketCoalescing
NdisReceiveFilterTypeUndefined (Const) => ndisReceiveFilterTypeUndefined
NdisReceiveFilterTypeVMQueue (Const) => ndisReceiveFilterTypeVMQueue
NdisReceiveQueueOperationalStateDmaStopped (Const) => ndisReceiveQueueOperationalStateDmaStopped
NdisReceiveQueueOperationalStateMaximum (Const) => ndisReceiveQueueOperationalStateMaximum
NdisReceiveQueueOperationalStatePaused (Const) => ndisReceiveQueueOperationalStatePaused
NdisReceiveQueueOperationalStateRunning (Const) => ndisReceiveQueueOperationalStateRunning
NdisReceiveQueueOperationalStateUndefined (Const) => ndisReceiveQueueOperationalStateUndefined
NdisReceiveQueueTypeMaximum (Const) => ndisReceiveQueueTypeMaximum
NdisReceiveQueueTypeUnspecified (Const) => ndisReceiveQueueTypeUnspecified
NdisReceiveQueueTypeVMQueue (Const) => ndisReceiveQueueTypeVMQueue
NdisRequestClose (Const) => ndisRequestClose
NdisRequestGeneric1 (Const) => ndisRequestGeneric1
NdisRequestGeneric2 (Const) => ndisRequestGeneric2
NdisRequestGeneric3 (Const) => ndisRequestGeneric3
NdisRequestGeneric4 (Const) => ndisRequestGeneric4
NdisRequestMethod (Const) => ndisRequestMethod
NdisRequestOpen (Const) => ndisRequestOpen
NdisRequestQueryInformation (Const) => ndisRequestQueryInformation
NdisRequestQueryStatistics (Const) => ndisRequestQueryStatistics
NdisRequestReset (Const) => ndisRequestReset
NdisRequestSend (Const) => ndisRequestSend
NdisRequestSetInformation (Const) => ndisRequestSetInformation
NdisRequestTransferData (Const) => ndisRequestTransferData
NdisRingStateClosed (Const) => ndisRingStateClosed
NdisRingStateClosing (Const) => ndisRingStateClosing
NdisRingStateOpened (Const) => ndisRingStateOpened
NdisRingStateOpenFailure (Const) => ndisRingStateOpenFailure
NdisRingStateOpening (Const) => ndisRingStateOpening
NdisRingStateRingFailure (Const) => ndisRingStateRingFailure
NdisRssProfileClosest (Const) => ndisRssProfileClosest
NdisRssProfileClosestStatic (Const) => ndisRssProfileClosestStatic
NdisRssProfileConservative (Const) => ndisRssProfileConservative
NdisRssProfileMaximum (Const) => ndisRssProfileMaximum
NdisRssProfileNuma (Const) => ndisRssProfileNuma
NdisRssProfileNumaStatic (Const) => ndisRssProfileNumaStatic
NdisSwitchFeatureStatusTypeCustom (Const) => ndisSwitchFeatureStatusTypeCustom
NdisSwitchFeatureStatusTypeMaximum (Const) => ndisSwitchFeatureStatusTypeMaximum
NdisSwitchFeatureStatusTypeUndefined (Const) => ndisSwitchFeatureStatusTypeUndefined
NdisSwitchNicStateConnected (Const) => ndisSwitchNicStateConnected
NdisSwitchNicStateCreated (Const) => ndisSwitchNicStateCreated
NdisSwitchNicStateDeleted (Const) => ndisSwitchNicStateDeleted
NdisSwitchNicStateDisconnected (Const) => ndisSwitchNicStateDisconnected
NdisSwitchNicStateUnknown (Const) => ndisSwitchNicStateUnknown
NdisSwitchNicTypeEmulated (Const) => ndisSwitchNicTypeEmulated
NdisSwitchNicTypeExternal (Const) => ndisSwitchNicTypeExternal
NdisSwitchNicTypeInternal (Const) => ndisSwitchNicTypeInternal
NdisSwitchNicTypeSynthetic (Const) => ndisSwitchNicTypeSynthetic
NdisSwitchPortFeatureStatusTypeCustom (Const) => ndisSwitchPortFeatureStatusTypeCustom
NdisSwitchPortFeatureStatusTypeMaximum (Const) => ndisSwitchPortFeatureStatusTypeMaximum
NdisSwitchPortFeatureStatusTypeUndefined (Const) => ndisSwitchPortFeatureStatusTypeUndefined
NdisSwitchPortPropertyTypeCustom (Const) => ndisSwitchPortPropertyTypeCustom
NdisSwitchPortPropertyTypeMaximum (Const) => ndisSwitchPortPropertyTypeMaximum
NdisSwitchPortPropertyTypeProfile (Const) => ndisSwitchPortPropertyTypeProfile
NdisSwitchPortPropertyTypeSecurity (Const) => ndisSwitchPortPropertyTypeSecurity
NdisSwitchPortPropertyTypeUndefined (Const) => ndisSwitchPortPropertyTypeUndefined
NdisSwitchPortPropertyTypeVlan (Const) => ndisSwitchPortPropertyTypeVlan
NdisSwitchPortPvlanModeCommunity (Const) => ndisSwitchPortPvlanModeCommunity
NdisSwitchPortPvlanModeIsolated (Const) => ndisSwitchPortPvlanModeIsolated
NdisSwitchPortPvlanModePromiscuous (Const) => ndisSwitchPortPvlanModePromiscuous
NdisSwitchPortPvlanModeUndefined (Const) => ndisSwitchPortPvlanModeUndefined
NdisSwitchPortStateCreated (Const) => ndisSwitchPortStateCreated
NdisSwitchPortStateDeleted (Const) => ndisSwitchPortStateDeleted
NdisSwitchPortStateTeardown (Const) => ndisSwitchPortStateTeardown
NdisSwitchPortStateUnknown (Const) => ndisSwitchPortStateUnknown
NdisSwitchPortTypeEmulated (Const) => ndisSwitchPortTypeEmulated
NdisSwitchPortTypeExternal (Const) => ndisSwitchPortTypeExternal
NdisSwitchPortTypeGeneric (Const) => ndisSwitchPortTypeGeneric
NdisSwitchPortTypeInternal (Const) => ndisSwitchPortTypeInternal
NdisSwitchPortTypeSynthetic (Const) => ndisSwitchPortTypeSynthetic
NdisSwitchPortVlanModeAccess (Const) => ndisSwitchPortVlanModeAccess
NdisSwitchPortVlanModeMax (Const) => ndisSwitchPortVlanModeMax
NdisSwitchPortVlanModePrivate (Const) => ndisSwitchPortVlanModePrivate
NdisSwitchPortVlanModeTrunk (Const) => ndisSwitchPortVlanModeTrunk
NdisSwitchPortVlanModeUnknown (Const) => ndisSwitchPortVlanModeUnknown
NdisSwitchPropertyTypeCustom (Const) => ndisSwitchPropertyTypeCustom
NdisSwitchPropertyTypeMaximum (Const) => ndisSwitchPropertyTypeMaximum
NdisSwitchPropertyTypeUndefined (Const) => ndisSwitchPropertyTypeUndefined
NdisUdpHeaderFieldDestinationPort (Const) => ndisUdpHeaderFieldDestinationPort
NdisUdpHeaderFieldMaximum (Const) => ndisUdpHeaderFieldMaximum
NdisUdpHeaderFieldUndefined (Const) => ndisUdpHeaderFieldUndefined
NdisWakeReasonMediaConnect (Const) => ndisWakeReasonMediaConnect
NdisWakeReasonMediaDisconnect (Const) => ndisWakeReasonMediaDisconnect
NdisWakeReasonPacket (Const) => ndisWakeReasonPacket
NdisWakeReasonUnspecified (Const) => ndisWakeReasonUnspecified
NdisWakeReasonWlan4WayHandshakeRequest (Const) => ndisWakeReasonWlan4WayHandshakeRequest
NdisWakeReasonWlanAPAssociationLost (Const) => ndisWakeReasonWlanAPAssociationLost
NdisWakeReasonWlanGTKHandshakeError (Const) => ndisWakeReasonWlanGTKHandshakeError
NdisWakeReasonWlanNLODiscovery (Const) => ndisWakeReasonWlanNLODiscovery
NdisWakeReasonWwanRegisterState (Const) => ndisWakeReasonWwanRegisterState
NdisWakeReasonWwanSMSReceive (Const) => ndisWakeReasonWwanSMSReceive
NdisWakeReasonWwanUSSDReceive (Const) => ndisWakeReasonWwanUSSDReceive
NdisWanErrorControl (Const) => ndisWanErrorControl
NdisWanHeaderEthernet (Const) => ndisWanHeaderEthernet
NdisWanHeaderNative (Const) => ndisWanHeaderNative
NdisWanMediumAgileVPN (Const) => ndisWanMediumAgileVPN
NdisWanMediumAtm (Const) => ndisWanMediumAtm
NdisWanMediumFrameRelay (Const) => ndisWanMediumFrameRelay
NdisWanMediumHub (Const) => ndisWanMediumHub
NdisWanMediumIrda (Const) => ndisWanMediumIrda
NdisWanMediumIsdn (Const) => ndisWanMediumIsdn
NdisWanMediumL2TP (Const) => ndisWanMediumL2TP
NdisWanMediumParallel (Const) => ndisWanMediumParallel
NdisWanMediumPppoe (Const) => ndisWanMediumPppoe
NdisWanMediumPPTP (Const) => ndisWanMediumPPTP
NdisWanMediumSerial (Const) => ndisWanMediumSerial
NdisWanMediumSonet (Const) => ndisWanMediumSonet
NdisWanMediumSSTP (Const) => ndisWanMediumSSTP
NdisWanMediumSW56K (Const) => ndisWanMediumSW56K
NdisWanRaw (Const) => ndisWanRaw
NdisWanReliable (Const) => ndisWanReliable
NegCallPackageMax (Const) => negCallPackageMax
NegEnumPackagePrefixes (Const) => negEnumPackagePrefixes
NegGetCallerName (Const) => negGetCallerName
NetAllComputerNames (Const) => netAllComputerNames
NetAlternateComputerNames (Const) => netAlternateComputerNames
NetComputerNameTypeMax (Const) => netComputerNameTypeMax
NetlogonGenericInformation (Const) => netlogonGenericInformation
NetlogonInteractiveInformation (Const) => netlogonInteractiveInformation
NetlogonInteractiveTransitiveInformation (Const) => netlogonInteractiveTransitiveInformation
NetlogonNetworkInformation (Const) => netlogonNetworkInformation
NetlogonNetworkTransitiveInformation (Const) => netlogonNetworkTransitiveInformation
NetlogonServiceInformation (Const) => netlogonServiceInformation
NetlogonServiceTransitiveInformation (Const) => netlogonServiceTransitiveInformation
NetPrimaryComputerName (Const) => netPrimaryComputerName
NetSetupDnsMachine (Const) => netSetupDnsMachine
NetSetupDomain (Const) => netSetupDomain
NetSetupDomainName (Const) => netSetupDomainName
NetSetupMachine (Const) => netSetupMachine
NetSetupNonExistentDomain (Const) => netSetupNonExistentDomain
NetSetupUnjoined (Const) => netSetupUnjoined
NetSetupUnknown (Const) => netSetupUnknown
NetSetupUnknownStatus (Const) => netSetupUnknownStatus
NetSetupWorkgroup (Const) => netSetupWorkgroup
NetSetupWorkgroupName (Const) => netSetupWorkgroupName
NetValidateAuthentication (Const) => netValidateAuthentication
NetValidatePasswordChange (Const) => netValidatePasswordChange
NetValidatePasswordReset (Const) => netValidatePasswordReset
Network (Const) => network
NetworkCategoryDomainAuthenticated (Const) => networkCategoryDomainAuthenticated
NetworkCategoryPrivate (Const) => networkCategoryPrivate
NetworkCategoryPublic (Const) => networkCategoryPublic
NetworkCategoryUnchanged (Const) => networkCategoryUnchanged
NetworkCategoryUnknown (Const) => networkCategoryUnknown
NetworkCleartext (Const) => networkCleartext
NewCredentials (Const) => newCredentials
NlatAnycast (Const) => nlatAnycast
NlatBroadcast (Const) => nlatBroadcast
NlatInvalid (Const) => nlatInvalid
NlatMulticast (Const) => nlatMulticast
NlatUnicast (Const) => nlatUnicast
NlatUnspecified (Const) => nlatUnspecified
NlbwDisabled (Const) => nlbwDisabled
NlbwEnabled (Const) => nlbwEnabled
NlbwUnchanged (Const) => nlbwUnchanged
NldsDeprecated (Const) => nldsDeprecated
NldsDuplicate (Const) => nldsDuplicate
NldsInvalid (Const) => nldsInvalid
NldsPreferred (Const) => nldsPreferred
NldsTentative (Const) => nldsTentative
NlincCategoryStateMax (Const) => nlincCategoryStateMax
NlincCategoryUnknown (Const) => nlincCategoryUnknown
NlincDomainAuthenticated (Const) => nlincDomainAuthenticated
NlincPrivate (Const) => nlincPrivate
NlincPublic (Const) => nlincPublic
NlnsDelay (Const) => nlnsDelay
NlnsIncomplete (Const) => nlnsIncomplete
NlnsMaximum (Const) => nlnsMaximum
NlnsPermanent (Const) => nlnsPermanent
NlnsProbe (Const) => nlnsProbe
NlnsReachable (Const) => nlnsReachable
NlnsStale (Const) => nlnsStale
NlnsUnreachable (Const) => nlnsUnreachable
NlpoDhcp (Const) => nlpoDhcp
NlpoManual (Const) => nlpoManual
NlpoOther (Const) => nlpoOther
NlpoRouterAdvertisement (Const) => nlpoRouterAdvertisement
NlpoWellKnown (Const) => nlpoWellKnown
Nlro6to4 (Const) => nlro6to4
NlroDHCP (Const) => nlroDHCP
NlroManual (Const) => nlroManual
NlroRouterAdvertisement (Const) => nlroRouterAdvertisement
NlroWellKnown (Const) => nlroWellKnown
NlsoDhcp (Const) => nlsoDhcp
NlsoLinkLayerAddress (Const) => nlsoLinkLayerAddress
NlsoManual (Const) => nlsoManual
NlsoOther (Const) => nlsoOther
NlsoRandom (Const) => nlsoRandom
NlsoWellKnown (Const) => nlsoWellKnown
NMCHAR (Object) => TNMCHAR
NMCLICK (Type) => TNMCLICK
NMCUSTOMDRAW (Object) => TNMCUSTOMDRAW
NMCUSTOMTEXT (Object) => TNMCUSTOMTEXT
NMTOOLTIPSCREATED (Object) => TNMTOOLTIPSCREATED
NMTVSTATEIMAGECHANGING (Object) => TNMTVSTATEIMAGECHANGING
NormalError (Const) => normalError
NormalizationC (Const) => normalizationC
NormalizationD (Const) => normalizationD
NormalizationKC (Const) => normalizationKC
NormalizationKD (Const) => normalizationKD
NormalizationOther (Const) => normalizationOther
NotificationEvent (Const) => notificationEvent
NotificationTimer (Const) => notificationTimer
NotifyUserModeLegacyPowerEvent (Const) => notifyUserModeLegacyPowerEvent
NotifyUserPowerSetting (Const) => notifyUserPowerSetting
NotImplemented (Const) => notImplemented
NotTrueTypeFont (Const) => notTrueTypeFont
NtProductLanManNt (Const) => ntProductLanManNt
NtProductServer (Const) => ntProductServer
NtProductWinNt (Const) => ntProductWinNt
NumSymTypes (Const) => numSymTypes
ObjectAllInformation (Const) => objectAllInformation
ObjectBasicInformation (Const) => objectBasicInformation
ObjectBusy (Const) => objectBusy
ObjectDataInformation (Const) => objectDataInformation
ObjectId (AccessProc) => objectId
ObjectIdType (Const) => objectIdType
ObjectNameInformation (Const) => objectNameInformation
OBJECTS_AND_NAME_ (Type) => OBJECTS_AND_NAME
ObjectTypeBrush (Const) => objectTypeBrush
ObjectTypeCustomLineCap (Const) => objectTypeCustomLineCap
ObjectTypeFont (Const) => objectTypeFont
ObjectTypeGraphics (Const) => objectTypeGraphics
ObjectTypeImageAttributes (Const) => objectTypeImageAttributes
ObjectTypeInformation (Const) => objectTypeInformation
ObjectTypeInvalid (Const) => objectTypeInvalid
ObjectTypeMax (Const) => objectTypeMax
ObjectTypeMin (Const) => objectTypeMin
ObjectTypePath (Const) => objectTypePath
ObjectTypePen (Const) => objectTypePen
ObjectTypeRegion (Const) => objectTypeRegion
ObjectTypeStringFormat (Const) => objectTypeStringFormat
OCM__BASE (Const) => OCM_BASE
OLEUIBUSY (Type) => TOLEUIBUSY
OLEUIBUSYA (Object) => TOLEUIBUSYA
OLEUIBUSYW (Object) => TOLEUIBUSYW
OLEUICHANGEICON (Type) => TOLEUICHANGEICON
OLEUICHANGEICONA (Object) => TOLEUICHANGEICONA
OLEUICHANGEICONW (Object) => TOLEUICHANGEICONW
OLEUICHANGESOURCE (Type) => TOLEUICHANGESOURCE
OLEUICHANGESOURCEA (Object) => TOLEUICHANGESOURCEA
OLEUICHANGESOURCEW (Object) => TOLEUICHANGESOURCEW
OLEUICONVERT (Type) => TOLEUICONVERT
OLEUICONVERTA (Object) => TOLEUICONVERTA
OLEUICONVERTW (Object) => TOLEUICONVERTW
OLEUIEDITLINKS (Type) => TOLEUIEDITLINKS
OLEUIEDITLINKSA (Object) => TOLEUIEDITLINKSA
OLEUIEDITLINKSW (Object) => TOLEUIEDITLINKSW
OLEUIINSERTOBJECT (Type) => TOLEUIINSERTOBJECT
OLEUIINSERTOBJECTA (Object) => TOLEUIINSERTOBJECTA
OLEUIINSERTOBJECTW (Object) => TOLEUIINSERTOBJECTW
OLEUIPASTESPECIAL (Type) => TOLEUIPASTESPECIAL
OLEUIPASTESPECIALA (Object) => TOLEUIPASTESPECIALA
OLEUIPASTESPECIALW (Object) => TOLEUIPASTESPECIALW
OutOfMemory (Const) => outOfMemory
PageIn (Const) => pageIn
PAGESETUPDLG (Type) => TPAGESETUPDLG
PAGESETUPDLGA (Object) => TPAGESETUPDLGA
PAGESETUPDLGW (Object) => TPAGESETUPDLGW
PaletteFlagsGrayScale (Const) => paletteFlagsGrayScale
PaletteFlagsHalftone (Const) => paletteFlagsHalftone
PaletteFlagsHasAlpha (Const) => paletteFlagsHasAlpha
PaletteTypeCustom (Const) => paletteTypeCustom
PaletteTypeFixedBW (Const) => paletteTypeFixedBW
PaletteTypeFixedHalftone125 (Const) => paletteTypeFixedHalftone125
PaletteTypeFixedHalftone216 (Const) => paletteTypeFixedHalftone216
PaletteTypeFixedHalftone252 (Const) => paletteTypeFixedHalftone252
PaletteTypeFixedHalftone256 (Const) => paletteTypeFixedHalftone256
PaletteTypeFixedHalftone27 (Const) => paletteTypeFixedHalftone27
PaletteTypeFixedHalftone64 (Const) => paletteTypeFixedHalftone64
PaletteTypeFixedHalftone8 (Const) => paletteTypeFixedHalftone8
PaletteTypeOptimal (Const) => paletteTypeOptimal
Parameter1 (Const) => parameter1
Parameter2 (Const) => parameter2
Parameter3 (Const) => parameter3
Parameter4 (Const) => parameter4
Parameter5 (Const) => parameter5
Parameter6 (Const) => parameter6
Parameter7 (Const) => parameter7
Parameter8 (Const) => parameter8
Parameter9 (Const) => parameter9
ParamNumber (Const) => paramNumber
ParamString (Const) => paramString
PartitionClassGuid (Const) => partitionClassGuid
PathPointTypeBezier (Const) => pathPointTypeBezier
PathPointTypeBezier3 (Const) => pathPointTypeBezier3
PathPointTypeCloseSubpath (Const) => pathPointTypeCloseSubpath
PathPointTypeLine (Const) => pathPointTypeLine
PathPointTypePathDashMode (Const) => pathPointTypePathDashMode
PathPointTypePathMarker (Const) => pathPointTypePathMarker
PathPointTypePathTypeMask (Const) => pathPointTypePathTypeMask
PathPointTypeStart (Const) => pathPointTypeStart
PcTeb (Const) => pcTeb
PdcInvocation (Const) => pdcInvocation
PenAlignment (Type) => GpPenAlignment
PenAlignmentCenter (Const) => penAlignmentCenter
PenAlignmentInset (Const) => penAlignmentInset
PenType (Type) => GpPenType
PenTypeHatchFill (Const) => penTypeHatchFill
PenTypeLinearGradient (Const) => penTypeLinearGradient
PenTypePathGradient (Const) => penTypePathGradient
PenTypeSolidColor (Const) => penTypeSolidColor
PenTypeTextureFill (Const) => penTypeTextureFill
PenTypeUnknown (Const) => penTypeUnknown
PEXPLICIT_ACCESS_ (Type) => PEXPLICIT_ACCESS
PixelFormat16bppARGB1555 (Const) => pixelFormat16bppARGB1555
PixelFormat16bppGrayScale (Const) => pixelFormat16bppGrayScale
PixelFormat16bppRGB555 (Const) => pixelFormat16bppRGB555
PixelFormat16bppRGB565 (Const) => pixelFormat16bppRGB565
PixelFormat1bppIndexed (Const) => pixelFormat1bppIndexed
PixelFormat24bppRGB (Const) => pixelFormat24bppRGB
PixelFormat32bppARGB (Const) => pixelFormat32bppARGB
PixelFormat32bppPARGB (Const) => pixelFormat32bppPARGB
PixelFormat32bppRGB (Const) => pixelFormat32bppRGB
PixelFormat48bppRGB (Const) => pixelFormat48bppRGB
PixelFormat4bppIndexed (Const) => pixelFormat4bppIndexed
PixelFormat64bppARGB (Const) => pixelFormat64bppARGB
PixelFormat64bppPARGB (Const) => pixelFormat64bppPARGB
PixelFormat8bppIndexed (Const) => pixelFormat8bppIndexed
PixelFormatAlpha (Const) => pixelFormatAlpha
PixelFormatCanonical (Const) => pixelFormatCanonical
PixelFormatDontCare (Const) => pixelFormatDontCare
PixelFormatExtended (Const) => pixelFormatExtended
PixelFormatGDI (Const) => pixelFormatGDI
PixelFormatIndexed (Const) => pixelFormatIndexed
PixelFormatMax (Const) => pixelFormatMax
PixelFormatPAlpha (Const) => pixelFormatPAlpha
PixelFormatUndefined (Const) => pixelFormatUndefined
PixelOffsetModeDefault (Const) => pixelOffsetModeDefault
PixelOffsetModeHalf (Const) => pixelOffsetModeHalf
PixelOffsetModeHighQuality (Const) => pixelOffsetModeHighQuality
PixelOffsetModeHighSpeed (Const) => pixelOffsetModeHighSpeed
PixelOffsetModeInvalid (Const) => pixelOffsetModeInvalid
PixelOffsetModeNone (Const) => pixelOffsetModeNone
PlatformInformation (Const) => platformInformation
PlatformRole (Const) => platformRole
PlatformRoleAppliancePC (Const) => platformRoleAppliancePC
PlatformRoleDesktop (Const) => platformRoleDesktop
PlatformRoleEnterpriseServer (Const) => platformRoleEnterpriseServer
PlatformRoleMaximum (Const) => platformRoleMaximum
PlatformRoleMobile (Const) => platformRoleMobile
PlatformRolePerformanceServer (Const) => platformRolePerformanceServer
PlatformRoleSlate (Const) => platformRoleSlate
PlatformRoleSOHOServer (Const) => platformRoleSOHOServer
PlatformRoleUnspecified (Const) => platformRoleUnspecified
PlatformRoleWorkstation (Const) => platformRoleWorkstation
PlmPowerRequestCreate (Const) => plmPowerRequestCreate
PMCCounter (Const) => pMCCounter
PoAc (Const) => poAc
POBJECTS_AND_NAME_ (Type) => POBJECTS_AND_NAME
PoConditionMaximum (Const) => poConditionMaximum
PoDc (Const) => poDc
PoHot (Const) => poHot
Point (Object) => GpPoint
PointF (Object) => GpPointF
PolicyAccountDomainInformation (Const) => policyAccountDomainInformation
PolicyAuditEventsInformation (Const) => policyAuditEventsInformation
PolicyAuditFullQueryInformation (Const) => policyAuditFullQueryInformation
PolicyAuditFullSetInformation (Const) => policyAuditFullSetInformation
PolicyAuditLogInformation (Const) => policyAuditLogInformation
PolicyDefaultQuotaInformation (Const) => policyDefaultQuotaInformation
PolicyDnsDomainInformation (Const) => policyDnsDomainInformation
PolicyDnsDomainInformationInt (Const) => policyDnsDomainInformationInt
PolicyDomainEfsInformation (Const) => policyDomainEfsInformation
PolicyDomainKerberosTicketInformation (Const) => policyDomainKerberosTicketInformation
PolicyLsaServerRoleInformation (Const) => policyLsaServerRoleInformation
PolicyModificationInformation (Const) => policyModificationInformation
PolicyNotifyAccountDomainInformation (Const) => policyNotifyAccountDomainInformation
PolicyNotifyAuditEventsInformation (Const) => policyNotifyAuditEventsInformation
PolicyNotifyDnsDomainInformation (Const) => policyNotifyDnsDomainInformation
PolicyNotifyDomainEfsInformation (Const) => policyNotifyDomainEfsInformation
PolicyNotifyDomainKerberosTicketInformation (Const) => policyNotifyDomainKerberosTicketInformation
PolicyNotifyMachineAccountPasswordInformation (Const) => policyNotifyMachineAccountPasswordInformation
PolicyNotifyServerRoleInformation (Const) => policyNotifyServerRoleInformation
PolicyPdAccountInformation (Const) => policyPdAccountInformation
PolicyPrimaryDomainInformation (Const) => policyPrimaryDomainInformation
PolicyReplicaSourceInformation (Const) => policyReplicaSourceInformation
PolicyServerRoleBackup (Const) => policyServerRoleBackup
PolicyServerRolePrimary (Const) => policyServerRolePrimary
Polite (Const) => polite
PoolAllocation (Const) => poolAllocation
PowerActionHibernate (Const) => powerActionHibernate
PowerActionNone (Const) => powerActionNone
PowerActionReserved (Const) => powerActionReserved
PowerActionShutdown (Const) => powerActionShutdown
PowerActionShutdownOff (Const) => powerActionShutdownOff
PowerActionShutdownReset (Const) => powerActionShutdownReset
PowerActionSleep (Const) => powerActionSleep
PowerActionWarmEject (Const) => powerActionWarmEject
PowerDeviceD0 (Const) => powerDeviceD0
PowerDeviceD1 (Const) => powerDeviceD1
PowerDeviceD2 (Const) => powerDeviceD2
PowerDeviceD3 (Const) => powerDeviceD3
PowerDeviceMaximum (Const) => powerDeviceMaximum
PowerDeviceUnspecified (Const) => powerDeviceUnspecified
PowerInformationLevelMaximum (Const) => powerInformationLevelMaximum
PowerInformationLevelUnused0 (Const) => powerInformationLevelUnused0
PowerMonitorDim (Const) => powerMonitorDim
PowerMonitorOff (Const) => powerMonitorOff
PowerMonitorOn (Const) => powerMonitorOn
PowerRequestAction (Const) => powerRequestAction
PowerRequestAwayModeRequired (Const) => powerRequestAwayModeRequired
PowerRequestCreate (Const) => powerRequestCreate
PowerRequestDisplayRequired (Const) => powerRequestDisplayRequired
PowerRequestExecutionRequired (Const) => powerRequestExecutionRequired
PowerRequestSystemRequired (Const) => powerRequestSystemRequired
PowerSettingNotificationName (Const) => powerSettingNotificationName
PowerShutdownNotification (Const) => powerShutdownNotification
PowerSystemHibernate (Const) => powerSystemHibernate
PowerSystemMaximum (Const) => powerSystemMaximum
PowerSystemShutdown (Const) => powerSystemShutdown
PowerSystemSleeping1 (Const) => powerSystemSleeping1
PowerSystemSleeping2 (Const) => powerSystemSleeping2
PowerSystemSleeping3 (Const) => powerSystemSleeping3
PowerSystemUnspecified (Const) => powerSystemUnspecified
PowerSystemWorking (Const) => powerSystemWorking
PowerUserInactive (Const) => powerUserInactive
PowerUserInvalid (Const) => powerUserInvalid
PowerUserMaximum (Const) => powerUserMaximum
PowerUserNotPresent (Const) => powerUserNotPresent
PowerUserPresent (Const) => powerUserPresent
PRINTDLG (Type) => TPRINTDLG
PRINTDLGA (Object) => TPRINTDLGA
PRINTDLGEX (Type) => TPRINTDLGEX
PRINTDLGEXA (Object) => TPRINTDLGEXA
PRINTDLGEXW (Object) => TPRINTDLGEXW
PRINTDLGW (Object) => TPRINTDLGW
ProcessAccessToken (Const) => processAccessToken
ProcessAffinityMask (Const) => processAffinityMask
ProcessAffinityUpdateMode (Const) => processAffinityUpdateMode
ProcessASLRPolicy (Const) => processASLRPolicy
ProcessBasePriority (Const) => processBasePriority
ProcessBasicInformation (Const) => processBasicInformation
ProcessBreakOnTermination (Const) => processBreakOnTermination
ProcessConsoleHostProcess (Const) => processConsoleHostProcess
ProcessCookie (Const) => processCookie
ProcessCycleTime (Const) => processCycleTime
ProcessDebugFlags (Const) => processDebugFlags
ProcessDebugObjectHandle (Const) => processDebugObjectHandle
ProcessDebugPort (Const) => processDebugPort
ProcessDefaultHardErrorMode (Const) => processDefaultHardErrorMode
ProcessDEPPolicy (Const) => processDEPPolicy
ProcessDeviceMap (Const) => processDeviceMap
ProcessEnableAlignmentFaultFixup (Const) => processEnableAlignmentFaultFixup
ProcessExceptionPort (Const) => processExceptionPort
ProcessExecuteFlags (Const) => processExecuteFlags
ProcessExtensionPointDisablePolicy (Const) => processExtensionPointDisablePolicy
ProcessForegroundInformation (Const) => processForegroundInformation
ProcessGroupInformation (Const) => processGroupInformation
ProcessHandleCount (Const) => processHandleCount
ProcessHandleTracing (Const) => processHandleTracing
ProcessImageFileMapping (Const) => processImageFileMapping
ProcessImageFileName (Const) => processImageFileName
ProcessImageFileNameWin32 (Const) => processImageFileNameWin32
ProcessImageInformation (Const) => processImageInformation
ProcessInformationClassMax (Const) => processInformationClassMax
ProcessInstrumentationCallback (Const) => processInstrumentationCallback
ProcessIoCounters (Const) => processIoCounters
ProcessIoPortHandlers (Const) => processIoPortHandlers
ProcessIoPriority (Const) => processIoPriority
ProcessLdtInformation (Const) => processLdtInformation
ProcessLdtSize (Const) => processLdtSize
ProcessLUIDDeviceMapsEnabled (Const) => processLUIDDeviceMapsEnabled
ProcessMemoryAllocationMode (Const) => processMemoryAllocationMode
ProcessMemoryPriority (Const) => processMemoryPriority
ProcessMitigationOptionsMask (Const) => processMitigationOptionsMask
ProcessorCap (Const) => processorCap
ProcessorIdleDomains (Const) => processorIdleDomains
ProcessorIdleStates (Const) => processorIdleStates
ProcessorIdleStatesHv (Const) => processorIdleStatesHv
ProcessorInformation (Const) => processorInformation
ProcessorInformationEx (Const) => processorInformationEx
ProcessorLoad (Const) => processorLoad
ProcessorPerfCapHv (Const) => processorPerfCapHv
ProcessorPerfStates (Const) => processorPerfStates
ProcessorPerfStatesHv (Const) => processorPerfStatesHv
ProcessorPowerPolicyAc (Const) => processorPowerPolicyAc
ProcessorPowerPolicyCurrent (Const) => processorPowerPolicyCurrent
ProcessorPowerPolicyDc (Const) => processorPowerPolicyDc
ProcessorSetIdle (Const) => processorSetIdle
ProcessorStateHandler (Const) => processorStateHandler
ProcessorStateHandler2 (Const) => processorStateHandler2
ProcessPagePriority (Const) => processPagePriority
ProcessPooledUsageAndLimits (Const) => processPooledUsageAndLimits
ProcessPriorityBoost (Const) => processPriorityBoost
ProcessPriorityClass (Const) => processPriorityClass
ProcessQuotaLimits (Const) => processQuotaLimits
ProcessRaisePriority (Const) => processRaisePriority
ProcessReserved1MitigationPolicy (Const) => processReserved1MitigationPolicy
ProcessSessionInformation (Const) => processSessionInformation
ProcessStrictHandleCheckPolicy (Const) => processStrictHandleCheckPolicy
ProcessSystemCallDisablePolicy (Const) => processSystemCallDisablePolicy
ProcessThreadStackAllocation (Const) => processThreadStackAllocation
ProcessTimes (Const) => processTimes
ProcessTlsInformation (Const) => processTlsInformation
ProcessTokenVirtualizationEnabled (Const) => processTokenVirtualizationEnabled
ProcessUserModeIOPL (Const) => processUserModeIOPL
ProcessVmCounters (Const) => processVmCounters
ProcessWindowInformation (Const) => processWindowInformation
ProcessWorkingSetWatch (Const) => processWorkingSetWatch
ProcessWorkingSetWatchEx (Const) => processWorkingSetWatchEx
ProcessWow64Information (Const) => processWow64Information
ProcessWx86Information (Const) => processWx86Information
ProcThreadAttributeGroupAffinity (Const) => procThreadAttributeGroupAffinity
ProcThreadAttributeHandleList (Const) => procThreadAttributeHandleList
ProcThreadAttributeIdealProcessor (Const) => procThreadAttributeIdealProcessor
ProcThreadAttributeMitigationPolicy (Const) => procThreadAttributeMitigationPolicy
ProcThreadAttributeParentProcess (Const) => procThreadAttributeParentProcess
ProcThreadAttributePreferredNode (Const) => procThreadAttributePreferredNode
ProcThreadAttributeSecurityCapabilities (Const) => procThreadAttributeSecurityCapabilities
ProcThreadAttributeUmsThread (Const) => procThreadAttributeUmsThread
ProfileNotFound (Const) => profileNotFound
ProgressCancelOperation (Const) => progressCancelOperation
ProgressInvokeEveryObject (Const) => progressInvokeEveryObject
ProgressInvokeNever (Const) => progressInvokeNever
ProgressInvokeOnError (Const) => progressInvokeOnError
ProgressInvokePrePostError (Const) => progressInvokePrePostError
ProgressRetryOperation (Const) => progressRetryOperation
PropertyExistsQuery (Const) => propertyExistsQuery
PropertyMaskQuery (Const) => propertyMaskQuery
PropertyNotFound (Const) => propertyNotFound
PropertyNotSupported (Const) => propertyNotSupported
PropertyQueryMaxDefined (Const) => propertyQueryMaxDefined
PropertyStandardQuery (Const) => propertyStandardQuery
PropertyTagArtist (Const) => propertyTagArtist
PropertyTagBitsPerSample (Const) => propertyTagBitsPerSample
PropertyTagCellHeight (Const) => propertyTagCellHeight
PropertyTagCellWidth (Const) => propertyTagCellWidth
PropertyTagChrominanceTable (Const) => propertyTagChrominanceTable
PropertyTagColorMap (Const) => propertyTagColorMap
PropertyTagColorTransferFunction (Const) => propertyTagColorTransferFunction
PropertyTagCompression (Const) => propertyTagCompression
PropertyTagCopyright (Const) => propertyTagCopyright
PropertyTagDateTime (Const) => propertyTagDateTime
PropertyTagDocumentName (Const) => propertyTagDocumentName
PropertyTagDotRange (Const) => propertyTagDotRange
PropertyTagEquipMake (Const) => propertyTagEquipMake
PropertyTagEquipModel (Const) => propertyTagEquipModel
PropertyTagExifAperture (Const) => propertyTagExifAperture
PropertyTagExifBrightness (Const) => propertyTagExifBrightness
PropertyTagExifCfaPattern (Const) => propertyTagExifCfaPattern
PropertyTagExifColorSpace (Const) => propertyTagExifColorSpace
PropertyTagExifCompBPP (Const) => propertyTagExifCompBPP
PropertyTagExifCompConfig (Const) => propertyTagExifCompConfig
PropertyTagExifDTDigitized (Const) => propertyTagExifDTDigitized
PropertyTagExifDTDigSS (Const) => propertyTagExifDTDigSS
PropertyTagExifDTOrig (Const) => propertyTagExifDTOrig
PropertyTagExifDTOrigSS (Const) => propertyTagExifDTOrigSS
PropertyTagExifDTSubsec (Const) => propertyTagExifDTSubsec
PropertyTagExifExposureBias (Const) => propertyTagExifExposureBias
PropertyTagExifExposureIndex (Const) => propertyTagExifExposureIndex
PropertyTagExifExposureProg (Const) => propertyTagExifExposureProg
PropertyTagExifExposureTime (Const) => propertyTagExifExposureTime
PropertyTagExifFileSource (Const) => propertyTagExifFileSource
PropertyTagExifFlash (Const) => propertyTagExifFlash
PropertyTagExifFlashEnergy (Const) => propertyTagExifFlashEnergy
PropertyTagExifFNumber (Const) => propertyTagExifFNumber
PropertyTagExifFocalLength (Const) => propertyTagExifFocalLength
PropertyTagExifFocalResUnit (Const) => propertyTagExifFocalResUnit
PropertyTagExifFocalXRes (Const) => propertyTagExifFocalXRes
PropertyTagExifFocalYRes (Const) => propertyTagExifFocalYRes
PropertyTagExifFPXVer (Const) => propertyTagExifFPXVer
PropertyTagExifIFD (Const) => propertyTagExifIFD
PropertyTagExifInterop (Const) => propertyTagExifInterop
PropertyTagExifISOSpeed (Const) => propertyTagExifISOSpeed
PropertyTagExifLightSource (Const) => propertyTagExifLightSource
PropertyTagExifMakerNote (Const) => propertyTagExifMakerNote
PropertyTagExifMaxAperture (Const) => propertyTagExifMaxAperture
PropertyTagExifMeteringMode (Const) => propertyTagExifMeteringMode
PropertyTagExifOECF (Const) => propertyTagExifOECF
PropertyTagExifPixXDim (Const) => propertyTagExifPixXDim
PropertyTagExifPixYDim (Const) => propertyTagExifPixYDim
PropertyTagExifRelatedWav (Const) => propertyTagExifRelatedWav
PropertyTagExifSceneType (Const) => propertyTagExifSceneType
PropertyTagExifSensingMethod (Const) => propertyTagExifSensingMethod
PropertyTagExifShutterSpeed (Const) => propertyTagExifShutterSpeed
PropertyTagExifSpatialFR (Const) => propertyTagExifSpatialFR
PropertyTagExifSpectralSense (Const) => propertyTagExifSpectralSense
PropertyTagExifSubjectDist (Const) => propertyTagExifSubjectDist
PropertyTagExifSubjectLoc (Const) => propertyTagExifSubjectLoc
PropertyTagExifUserComment (Const) => propertyTagExifUserComment
PropertyTagExifVer (Const) => propertyTagExifVer
PropertyTagExtraSamples (Const) => propertyTagExtraSamples
PropertyTagFillOrder (Const) => propertyTagFillOrder
PropertyTagFrameDelay (Const) => propertyTagFrameDelay
PropertyTagFreeByteCounts (Const) => propertyTagFreeByteCounts
PropertyTagFreeOffset (Const) => propertyTagFreeOffset
PropertyTagGamma (Const) => propertyTagGamma
PropertyTagGlobalPalette (Const) => propertyTagGlobalPalette
PropertyTagGpsAltitude (Const) => propertyTagGpsAltitude
PropertyTagGpsAltitudeRef (Const) => propertyTagGpsAltitudeRef
PropertyTagGpsDestBear (Const) => propertyTagGpsDestBear
PropertyTagGpsDestBearRef (Const) => propertyTagGpsDestBearRef
PropertyTagGpsDestDist (Const) => propertyTagGpsDestDist
PropertyTagGpsDestDistRef (Const) => propertyTagGpsDestDistRef
PropertyTagGpsDestLat (Const) => propertyTagGpsDestLat
PropertyTagGpsDestLatRef (Const) => propertyTagGpsDestLatRef
PropertyTagGpsDestLong (Const) => propertyTagGpsDestLong
PropertyTagGpsDestLongRef (Const) => propertyTagGpsDestLongRef
PropertyTagGpsGpsDop (Const) => propertyTagGpsGpsDop
PropertyTagGpsGpsMeasureMode (Const) => propertyTagGpsGpsMeasureMode
PropertyTagGpsGpsSatellites (Const) => propertyTagGpsGpsSatellites
PropertyTagGpsGpsStatus (Const) => propertyTagGpsGpsStatus
PropertyTagGpsGpsTime (Const) => propertyTagGpsGpsTime
PropertyTagGpsIFD (Const) => propertyTagGpsIFD
PropertyTagGpsImgDir (Const) => propertyTagGpsImgDir
PropertyTagGpsImgDirRef (Const) => propertyTagGpsImgDirRef
PropertyTagGpsLatitude (Const) => propertyTagGpsLatitude
PropertyTagGpsLatitudeRef (Const) => propertyTagGpsLatitudeRef
PropertyTagGpsLongitude (Const) => propertyTagGpsLongitude
PropertyTagGpsLongitudeRef (Const) => propertyTagGpsLongitudeRef
PropertyTagGpsMapDatum (Const) => propertyTagGpsMapDatum
PropertyTagGpsSpeed (Const) => propertyTagGpsSpeed
PropertyTagGpsSpeedRef (Const) => propertyTagGpsSpeedRef
PropertyTagGpsTrack (Const) => propertyTagGpsTrack
PropertyTagGpsTrackRef (Const) => propertyTagGpsTrackRef
PropertyTagGpsVer (Const) => propertyTagGpsVer
PropertyTagGrayResponseCurve (Const) => propertyTagGrayResponseCurve
PropertyTagGrayResponseUnit (Const) => propertyTagGrayResponseUnit
PropertyTagGridSize (Const) => propertyTagGridSize
PropertyTagHalftoneDegree (Const) => propertyTagHalftoneDegree
PropertyTagHalftoneHints (Const) => propertyTagHalftoneHints
PropertyTagHalftoneLPI (Const) => propertyTagHalftoneLPI
PropertyTagHalftoneLPIUnit (Const) => propertyTagHalftoneLPIUnit
PropertyTagHalftoneMisc (Const) => propertyTagHalftoneMisc
PropertyTagHalftoneScreen (Const) => propertyTagHalftoneScreen
PropertyTagHalftoneShape (Const) => propertyTagHalftoneShape
PropertyTagHostComputer (Const) => propertyTagHostComputer
PropertyTagICCProfile (Const) => propertyTagICCProfile
PropertyTagICCProfileDescriptor (Const) => propertyTagICCProfileDescriptor
PropertyTagImageDescription (Const) => propertyTagImageDescription
PropertyTagImageHeight (Const) => propertyTagImageHeight
PropertyTagImageTitle (Const) => propertyTagImageTitle
PropertyTagImageWidth (Const) => propertyTagImageWidth
PropertyTagIndexBackground (Const) => propertyTagIndexBackground
PropertyTagIndexTransparent (Const) => propertyTagIndexTransparent
PropertyTagInkNames (Const) => propertyTagInkNames
PropertyTagInkSet (Const) => propertyTagInkSet
PropertyTagJPEGACTables (Const) => propertyTagJPEGACTables
PropertyTagJPEGDCTables (Const) => propertyTagJPEGDCTables
PropertyTagJPEGInterFormat (Const) => propertyTagJPEGInterFormat
PropertyTagJPEGInterLength (Const) => propertyTagJPEGInterLength
PropertyTagJPEGLosslessPredictors (Const) => propertyTagJPEGLosslessPredictors
PropertyTagJPEGPointTransforms (Const) => propertyTagJPEGPointTransforms
PropertyTagJPEGProc (Const) => propertyTagJPEGProc
PropertyTagJPEGQTables (Const) => propertyTagJPEGQTables
PropertyTagJPEGQuality (Const) => propertyTagJPEGQuality
PropertyTagJPEGRestartInterval (Const) => propertyTagJPEGRestartInterval
PropertyTagLoopCount (Const) => propertyTagLoopCount
PropertyTagLuminanceTable (Const) => propertyTagLuminanceTable
PropertyTagMaxSampleValue (Const) => propertyTagMaxSampleValue
PropertyTagMinSampleValue (Const) => propertyTagMinSampleValue
PropertyTagNewSubfileType (Const) => propertyTagNewSubfileType
PropertyTagNumberOfInks (Const) => propertyTagNumberOfInks
PropertyTagOrientation (Const) => propertyTagOrientation
PropertyTagPageName (Const) => propertyTagPageName
PropertyTagPageNumber (Const) => propertyTagPageNumber
PropertyTagPaletteHistogram (Const) => propertyTagPaletteHistogram
PropertyTagPhotometricInterp (Const) => propertyTagPhotometricInterp
PropertyTagPixelPerUnitX (Const) => propertyTagPixelPerUnitX
PropertyTagPixelPerUnitY (Const) => propertyTagPixelPerUnitY
PropertyTagPixelUnit (Const) => propertyTagPixelUnit
PropertyTagPlanarConfig (Const) => propertyTagPlanarConfig
PropertyTagPredictor (Const) => propertyTagPredictor
PropertyTagPrimaryChromaticities (Const) => propertyTagPrimaryChromaticities
PropertyTagPrintFlags (Const) => propertyTagPrintFlags
PropertyTagPrintFlagsBleedWidth (Const) => propertyTagPrintFlagsBleedWidth
PropertyTagPrintFlagsBleedWidthScale (Const) => propertyTagPrintFlagsBleedWidthScale
PropertyTagPrintFlagsCrop (Const) => propertyTagPrintFlagsCrop
PropertyTagPrintFlagsVersion (Const) => propertyTagPrintFlagsVersion
PropertyTagREFBlackWhite (Const) => propertyTagREFBlackWhite
PropertyTagResolutionUnit (Const) => propertyTagResolutionUnit
PropertyTagResolutionXLengthUnit (Const) => propertyTagResolutionXLengthUnit
PropertyTagResolutionXUnit (Const) => propertyTagResolutionXUnit
PropertyTagResolutionYLengthUnit (Const) => propertyTagResolutionYLengthUnit
PropertyTagResolutionYUnit (Const) => propertyTagResolutionYUnit
PropertyTagRowsPerStrip (Const) => propertyTagRowsPerStrip
PropertyTagSampleFormat (Const) => propertyTagSampleFormat
PropertyTagSamplesPerPixel (Const) => propertyTagSamplesPerPixel
PropertyTagSMaxSampleValue (Const) => propertyTagSMaxSampleValue
PropertyTagSMinSampleValue (Const) => propertyTagSMinSampleValue
PropertyTagSoftwareUsed (Const) => propertyTagSoftwareUsed
PropertyTagSRGBRenderingIntent (Const) => propertyTagSRGBRenderingIntent
PropertyTagStripBytesCount (Const) => propertyTagStripBytesCount
PropertyTagStripOffsets (Const) => propertyTagStripOffsets
PropertyTagSubfileType (Const) => propertyTagSubfileType
PropertyTagT4Option (Const) => propertyTagT4Option
PropertyTagT6Option (Const) => propertyTagT6Option
PropertyTagTargetPrinter (Const) => propertyTagTargetPrinter
PropertyTagThreshHolding (Const) => propertyTagThreshHolding
PropertyTagThumbnailArtist (Const) => propertyTagThumbnailArtist
PropertyTagThumbnailBitsPerSample (Const) => propertyTagThumbnailBitsPerSample
PropertyTagThumbnailColorDepth (Const) => propertyTagThumbnailColorDepth
PropertyTagThumbnailCompressedSize (Const) => propertyTagThumbnailCompressedSize
PropertyTagThumbnailCompression (Const) => propertyTagThumbnailCompression
PropertyTagThumbnailCopyRight (Const) => propertyTagThumbnailCopyRight
PropertyTagThumbnailData (Const) => propertyTagThumbnailData
PropertyTagThumbnailDateTime (Const) => propertyTagThumbnailDateTime
PropertyTagThumbnailEquipMake (Const) => propertyTagThumbnailEquipMake
PropertyTagThumbnailEquipModel (Const) => propertyTagThumbnailEquipModel
PropertyTagThumbnailFormat (Const) => propertyTagThumbnailFormat
PropertyTagThumbnailHeight (Const) => propertyTagThumbnailHeight
PropertyTagThumbnailImageDescription (Const) => propertyTagThumbnailImageDescription
PropertyTagThumbnailImageHeight (Const) => propertyTagThumbnailImageHeight
PropertyTagThumbnailImageWidth (Const) => propertyTagThumbnailImageWidth
PropertyTagThumbnailOrientation (Const) => propertyTagThumbnailOrientation
PropertyTagThumbnailPhotometricInterp (Const) => propertyTagThumbnailPhotometricInterp
PropertyTagThumbnailPlanarConfig (Const) => propertyTagThumbnailPlanarConfig
PropertyTagThumbnailPlanes (Const) => propertyTagThumbnailPlanes
PropertyTagThumbnailPrimaryChromaticities (Const) => propertyTagThumbnailPrimaryChromaticities
PropertyTagThumbnailRawBytes (Const) => propertyTagThumbnailRawBytes
PropertyTagThumbnailRefBlackWhite (Const) => propertyTagThumbnailRefBlackWhite
PropertyTagThumbnailResolutionUnit (Const) => propertyTagThumbnailResolutionUnit
PropertyTagThumbnailResolutionX (Const) => propertyTagThumbnailResolutionX
PropertyTagThumbnailResolutionY (Const) => propertyTagThumbnailResolutionY
PropertyTagThumbnailRowsPerStrip (Const) => propertyTagThumbnailRowsPerStrip
PropertyTagThumbnailSamplesPerPixel (Const) => propertyTagThumbnailSamplesPerPixel
PropertyTagThumbnailSize (Const) => propertyTagThumbnailSize
PropertyTagThumbnailSoftwareUsed (Const) => propertyTagThumbnailSoftwareUsed
PropertyTagThumbnailStripBytesCount (Const) => propertyTagThumbnailStripBytesCount
PropertyTagThumbnailStripOffsets (Const) => propertyTagThumbnailStripOffsets
PropertyTagThumbnailTransferFunction (Const) => propertyTagThumbnailTransferFunction
PropertyTagThumbnailWhitePoint (Const) => propertyTagThumbnailWhitePoint
PropertyTagThumbnailWidth (Const) => propertyTagThumbnailWidth
PropertyTagThumbnailYCbCrCoefficients (Const) => propertyTagThumbnailYCbCrCoefficients
PropertyTagThumbnailYCbCrPositioning (Const) => propertyTagThumbnailYCbCrPositioning
PropertyTagThumbnailYCbCrSubsampling (Const) => propertyTagThumbnailYCbCrSubsampling
PropertyTagTileByteCounts (Const) => propertyTagTileByteCounts
PropertyTagTileLength (Const) => propertyTagTileLength
PropertyTagTileOffset (Const) => propertyTagTileOffset
PropertyTagTileWidth (Const) => propertyTagTileWidth
PropertyTagTransferFunction (Const) => propertyTagTransferFunction
PropertyTagTransferRange (Const) => propertyTagTransferRange
PropertyTagTypeASCII (Const) => propertyTagTypeASCII
PropertyTagTypeByte (Const) => propertyTagTypeByte
PropertyTagTypeLong (Const) => propertyTagTypeLong
PropertyTagTypeRational (Const) => propertyTagTypeRational
PropertyTagTypeShort (Const) => propertyTagTypeShort
PropertyTagTypeSLONG (Const) => propertyTagTypeSLONG
PropertyTagTypeSRational (Const) => propertyTagTypeSRational
PropertyTagTypeUndefined (Const) => propertyTagTypeUndefined
PropertyTagWhitePoint (Const) => propertyTagWhitePoint
PropertyTagXPosition (Const) => propertyTagXPosition
PropertyTagXResolution (Const) => propertyTagXResolution
PropertyTagYCbCrCoefficients (Const) => propertyTagYCbCrCoefficients
PropertyTagYCbCrPositioning (Const) => propertyTagYCbCrPositioning
PropertyTagYCbCrSubsampling (Const) => propertyTagYCbCrSubsampling
PropertyTagYPosition (Const) => propertyTagYPosition
PropertyTagYResolution (Const) => propertyTagYResolution
Proxy (Const) => proxy
PTRUSTEE_ (Type) => PTRUSTEE
QualityModeDefault (Const) => qualityModeDefault
QualityModeHigh (Const) => qualityModeHigh
QualityModeInvalid (Const) => qualityModeInvalid
QualityModeLow (Const) => qualityModeLow
QUERY_SERVICE_CONFIG (Type) => TQUERY_SERVICE_CONFIG
QUERY_SERVICE_CONFIGA (Object) => TQUERY_SERVICE_CONFIGA
QUERY_SERVICE_CONFIGW (Object) => TQUERY_SERVICE_CONFIGW
QUERY_SERVICE_LOCK_STATUS (Type) => TQUERY_SERVICE_LOCK_STATUS
QUERY_SERVICE_LOCK_STATUSA (Object) => TQUERY_SERVICE_LOCK_STATUSA
QUERY_SERVICE_LOCK_STATUSW (Object) => TQUERY_SERVICE_LOCK_STATUSW
QueryOption (Method) => mQueryOption
RASDIALDLG (Object) => TRASDIALDLG
RASENTRYDLG (Type) => TRASENTRYDLG
RASENTRYDLGA (Object) => TRASENTRYDLGA
RASENTRYDLGW (Object) => TRASENTRYDLGW
ReadMemoryFailureCallback (Const) => readMemoryFailureCallback
RecognizerType (Const) => recognizerType
Rect (Object) => GpRect
RectF (Object) => GpRectF
RegisterWord (Method) => mRegisterWord
RegisterWordA (Method) => mRegisterWordA
RegisterWordW (Method) => mRegisterWordW
RelationAll (Const) => relationAll
RelationCache (Const) => relationCache
RelationGroup (Const) => relationGroup
RelationNumaNode (Const) => relationNumaNode
RelationProcessorCore (Const) => relationProcessorCore
RelationProcessorPackage (Const) => relationProcessorPackage
RemoteInteractive (Const) => remoteInteractive
RemovableMedia (Const) => removableMedia
RemoveMemoryCallback (Const) => removeMemoryCallback
RequestLocation (Const) => requestLocation
RequestSize (Const) => requestSize
ReservedStream0 (Const) => reservedStream0
ReservedStream1 (Const) => reservedStream1
ResourceManagerBasicInformation (Const) => resourceManagerBasicInformation
ResourceManagerCompletionInformation (Const) => resourceManagerCompletionInformation
Rotate180FlipNone (Const) => rotate180FlipNone
Rotate180FlipX (Const) => rotate180FlipX
Rotate180FlipXY (Const) => rotate180FlipXY
Rotate180FlipY (Const) => rotate180FlipY
Rotate270FlipNone (Const) => rotate270FlipNone
Rotate270FlipX (Const) => rotate270FlipX
Rotate270FlipXY (Const) => rotate270FlipXY
Rotate270FlipY (Const) => rotate270FlipY
Rotate90FlipNone (Const) => rotate90FlipNone
Rotate90FlipX (Const) => rotate90FlipX
Rotate90FlipXY (Const) => rotate90FlipXY
Rotate90FlipY (Const) => rotate90FlipY
RotateNoneFlipNone (Const) => rotateNoneFlipNone
RotateNoneFlipX (Const) => rotateNoneFlipX
RotateNoneFlipXY (Const) => rotateNoneFlipXY
RotateNoneFlipY (Const) => rotateNoneFlipY
RouteProtocolBbn (Const) => routeProtocolBbn
RouteProtocolBgp (Const) => routeProtocolBgp
RouteProtocolCisco (Const) => routeProtocolCisco
RouteProtocolEgp (Const) => routeProtocolEgp
RouteProtocolEsIs (Const) => routeProtocolEsIs
RouteProtocolGgp (Const) => routeProtocolGgp
RouteProtocolHello (Const) => routeProtocolHello
RouteProtocolIcmp (Const) => routeProtocolIcmp
RouteProtocolIsIs (Const) => routeProtocolIsIs
RouteProtocolLocal (Const) => routeProtocolLocal
RouteProtocolNetMgmt (Const) => routeProtocolNetMgmt
RouteProtocolOspf (Const) => routeProtocolOspf
RouteProtocolOther (Const) => routeProtocolOther
RouteProtocolRip (Const) => routeProtocolRip
RouterDiscoveryDhcp (Const) => routerDiscoveryDhcp
RouterDiscoveryDisabled (Const) => routerDiscoveryDisabled
RouterDiscoveryEnabled (Const) => routerDiscoveryEnabled
RouterDiscoveryUnchanged (Const) => routerDiscoveryUnchanged
RpcCallComplete (Const) => rpcCallComplete
RpcNotificationCallCancel (Const) => rpcNotificationCallCancel
RpcNotificationCallNone (Const) => rpcNotificationCallNone
RpcNotificationClientDisconnect (Const) => rpcNotificationClientDisconnect
RpcNotificationTypeApc (Const) => rpcNotificationTypeApc
RpcNotificationTypeCallback (Const) => rpcNotificationTypeCallback
RpcNotificationTypeEvent (Const) => rpcNotificationTypeEvent
RpcNotificationTypeHwnd (Const) => rpcNotificationTypeHwnd
RpcNotificationTypeIoc (Const) => rpcNotificationTypeIoc
RpcNotificationTypeNone (Const) => rpcNotificationTypeNone
RpcReceiveComplete (Const) => rpcReceiveComplete
RpcSendComplete (Const) => rpcSendComplete
RunlevelInformationInActivationContext (Const) => runlevelInformationInActivationContext
ScopeLevelAdmin (Const) => scopeLevelAdmin
ScopeLevelCount (Const) => scopeLevelCount
ScopeLevelGlobal (Const) => scopeLevelGlobal
ScopeLevelInterface (Const) => scopeLevelInterface
ScopeLevelLink (Const) => scopeLevelLink
ScopeLevelOrganization (Const) => scopeLevelOrganization
ScopeLevelSite (Const) => scopeLevelSite
ScopeLevelSubnet (Const) => scopeLevelSubnet
ScreenOff (Const) => screenOff
SCRIPTSTATE (Type) => TSCRIPTSTATE
SeAdtParmTypeAccessMask (Const) => seAdtParmTypeAccessMask
SeAdtParmTypeDateTime (Const) => seAdtParmTypeDateTime
SeAdtParmTypeDuration (Const) => seAdtParmTypeDuration
SeAdtParmTypeFileSpec (Const) => seAdtParmTypeFileSpec
SeAdtParmTypeGuid (Const) => seAdtParmTypeGuid
SeAdtParmTypeHexInt64 (Const) => seAdtParmTypeHexInt64
SeAdtParmTypeHexUlong (Const) => seAdtParmTypeHexUlong
SeAdtParmTypeLogonId (Const) => seAdtParmTypeLogonId
SeAdtParmTypeLuid (Const) => seAdtParmTypeLuid
SeAdtParmTypeMessage (Const) => seAdtParmTypeMessage
SeAdtParmTypeNoLogonId (Const) => seAdtParmTypeNoLogonId
SeAdtParmTypeNone (Const) => seAdtParmTypeNone
SeAdtParmTypeNoUac (Const) => seAdtParmTypeNoUac
SeAdtParmTypeObjectTypes (Const) => seAdtParmTypeObjectTypes
SeAdtParmTypePrivs (Const) => seAdtParmTypePrivs
SeAdtParmTypePtr (Const) => seAdtParmTypePtr
SeAdtParmTypeSid (Const) => seAdtParmTypeSid
SeAdtParmTypeSidList (Const) => seAdtParmTypeSidList
SeAdtParmTypeSockAddr (Const) => seAdtParmTypeSockAddr
SeAdtParmTypeString (Const) => seAdtParmTypeString
SeAdtParmTypeStringList (Const) => seAdtParmTypeStringList
SeAdtParmTypeTime (Const) => seAdtParmTypeTime
SeAdtParmTypeUlong (Const) => seAdtParmTypeUlong
SeAdtParmTypeUserAccountControl (Const) => seAdtParmTypeUserAccountControl
SecDirectory (Const) => secDirectory
SecFull (Const) => secFull
SecObject (Const) => secObject
SecondaryFlagsCallback (Const) => secondaryFlagsCallback
SecService (Const) => secService
SecTree (Const) => secTree
SecurityAnonymous (Const) => securityAnonymous
SecurityDelegation (Const) => securityDelegation
SecurityIdentification (Const) => securityIdentification
SecurityImpersonation (Const) => securityImpersonation
SeLearningModeInvalidType (Const) => seLearningModeInvalidType
SeLearningModeMax (Const) => seLearningModeMax
SeLearningModeSettings (Const) => seLearningModeSettings
ServerApplication (Const) => serverApplication
Service (Const) => service
ServiceStart (Method) => mServiceStart
ServiceStop (Method) => mServiceStop
SessionConnectNotification (Const) => sessionConnectNotification
SessionDisplayState (Const) => sessionDisplayState
SessionLockState (Const) => sessionLockState
SessionPowerCleanup (Const) => sessionPowerCleanup
SessionPowerInit (Const) => sessionPowerInit
SessionRITState (Const) => sessionRITState
SET_ARC_DIRECTION (Const) => setArcDirection
SETABORTPROC (Const) => setAbortProc
SetBackgroundColor (Method) => mSetBackgroundColor
SETMITERLIMIT (Const) => setMiterLimit
SetPowerSettingValue (Const) => setPowerSettingValue
SetShutdownSelectedTime (Const) => setShutdownSelectedTime
SetupFileLogChecksum (Const) => setupFileLogChecksum
SetupFileLogDiskDescription (Const) => setupFileLogDiskDescription
SetupFileLogDiskTagfile (Const) => setupFileLogDiskTagfile
SetupFileLogMax (Const) => setupFileLogMax
SetupFileLogOtherInfo (Const) => setupFileLogOtherInfo
SetupFileLogSourceFilename (Const) => setupFileLogSourceFilename
SevereError (Const) => severeError
SHARDAPPIDINFO (Object) => TSHARDAPPIDINFO
SHARDAPPIDINFOIDLIST (Object) => TSHARD_APPIDINFOIDLIST
SHARDAPPIDINFOLINK (Object) => TSHARDAPPIDINFOLINK
ShrinkAbort (Const) => shrinkAbort
ShrinkCommit (Const) => shrinkCommit
ShrinkPrepare (Const) => shrinkPrepare
SidTypeAlias (Const) => sidTypeAlias
SidTypeComputer (Const) => sidTypeComputer
SidTypeDeletedAccount (Const) => sidTypeDeletedAccount
SidTypeDomain (Const) => sidTypeDomain
SidTypeGroup (Const) => sidTypeGroup
SidTypeInvalid (Const) => sidTypeInvalid
SidTypeLabel (Const) => sidTypeLabel
SidTypeUnknown (Const) => sidTypeUnknown
SidTypeUser (Const) => sidTypeUser
SidTypeWellKnownGroup (Const) => sidTypeWellKnownGroup
Size (Object) => GpSize
Size (Method) => mSize
SizeF (Object) => GpSizeF
SmoothingModeAntiAlias (Const) => smoothingModeAntiAlias
SmoothingModeAntiAlias8x4 (Const) => smoothingModeAntiAlias8x4
SmoothingModeAntiAlias8x8 (Const) => smoothingModeAntiAlias8x8
SmoothingModeDefault (Const) => smoothingModeDefault
SmoothingModeHighQuality (Const) => smoothingModeHighQuality
SmoothingModeHighSpeed (Const) => smoothingModeHighSpeed
SmoothingModeInvalid (Const) => smoothingModeInvalid
SmoothingModeNone (Const) => smoothingModeNone
SOUNDSENTRY (Type) => TSOUNDSENTRY
Spare2 (Const) => spare2
Spare3 (Const) => spare3
Spare4 (Const) => spare4
Spare5 (Const) => spare5
Spare6 (Const) => spare6
SQL_DATE_STRUCT (Type) => TSQL_DATE_STRUCT
SQL_DAY_SECOND_STRUCT (Object) => TSQL_DAY_SECOND_STRUCT
SQL_INTERVAL_STRUCT (Object) => TSQL_INTERVAL_STRUCT
SQL_NUMERIC_STRUCT (Object) => TSQL_NUMERIC_STRUCT
SQL_PROCEDURES (Const) => sqlProcedures
SQL_TIME_STRUCT (Type) => TSQL_TIME_STRUCT
SQL_TIMESTAMP_STRUCT (Type) => TSQL_TIMESTAMP_STRUCT
SQL_YEAR_MONTH_STRUCT (Object) => TSQL_YEAR_MONTH_STRUCT
SQLBIGINT (Type) => TSQLBIGINT
SQLCHAR (Type) => TSQLCHAR
SQLDATE (Type) => TSQLDATE
SQLDECIMAL (Type) => TSQLDECIMAL
SQLDOUBLE (Type) => TSQLDOUBLE
SQLFLOAT (Type) => TSQLFLOAT
SQLGUID (Type) => TSQLGUID
SQLHANDLE (Type) => TSQLHANDLE
SQLHDBC (Type) => TSQLHDBC
SQLHDESC (Type) => TSQLHDESC
SQLHENV (Type) => TSQLHENV
SQLHSTMT (Type) => TSQLHSTMT
SQLHWND (Type) => TSQLHWND
SQLINTEGER (Type) => TSQLINTEGER
SQLINTERVAL (Type) => TSQLINTERVAL
SQLLEN (Type) => TSQLLEN
SQLNUMERIC (Type) => TSQLNUMERIC
SQLPOINTER (Type) => TSQLPOINTER
SQLREAL (Type) => TSQLREAL
SQLRETURN (Type) => TSQLRETURN
SQLROWCOUNT (Type) => TSQLROWCOUNT
SQLROWOFFSET (Type) => TSQLROWOFFSET
SQLROWSETSIZE (Type) => TSQLROWSETSIZE
SQLSCHAR (Type) => TSQLSCHAR
SQLSETPOSIROW (Type) => TSQLSETPOSIROW
SQLSMALLINT (Type) => TSQLSMALLINT
SQLTCHAR (Type) => TSQLTCHAR
SQLTIME (Type) => TSQLTIME
SQLTIMESTAMP (Type) => TSQLTIMESTAMP
SQLTRANSID (Type) => TSQLTRANSID
SQLUBIGINT (Type) => TSQLUBIGINT
SQLUINTEGER (Type) => TSQLUINTEGER
SQLULEN (Type) => TSQLULEN
SQLUSMALLINT (Type) => TSQLUSMALLINT
SQLVARCHAR (Type) => TSQLVARCHAR
SQLWCHAR (Type) => TSQLWCHAR
STARTDOC (Const) => startDoc
startDoc (Method) => mStartDoc
StateInitialized (Const) => stateInitialized
StateReady (Const) => stateReady
StateRunning (Const) => stateRunning
StateStandby (Const) => stateStandby
StateTerminated (Const) => stateTerminated
StateTransition (Const) => stateTransition
StateUnknown (Const) => stateUnknown
StateWait (Const) => stateWait
StorageAccessAlignmentProperty (Const) => storageAccessAlignmentProperty
StorageAdapterProperty (Const) => storageAdapterProperty
StorageDeviceIdProperty (Const) => storageDeviceIdProperty
StorageDeviceProperty (Const) => storageDeviceProperty
StorageDeviceSeekPenaltyProperty (Const) => storageDeviceSeekPenaltyProperty
StorageDeviceTrimProperty (Const) => storageDeviceTrimProperty
StorageDeviceUniqueIdProperty (Const) => storageDeviceUniqueIdProperty
StorageDeviceWriteCacheProperty (Const) => storageDeviceWriteCacheProperty
StorageMiniportProperty (Const) => storageMiniportProperty
StoragePortClassGuid (Const) => storagePortClassGuid
StoragePortCodeSetReserved (Const) => storagePortCodeSetReserved
StoragePortCodeSetSCSIport (Const) => storagePortCodeSetSCSIport
StoragePortCodeSetStorport (Const) => storagePortCodeSetStorport
STRETCHBLT (Const) => stretchBlt
StringAlignmentCenter (Const) => stringAlignmentCenter
StringAlignmentFar (Const) => stringAlignmentFar
StringAlignmentNear (Const) => stringAlignmentNear
StringDigitSubstituteNational (Const) => stringDigitSubstituteNational
StringDigitSubstituteNone (Const) => stringDigitSubstituteNone
StringDigitSubstituteTraditional (Const) => stringDigitSubstituteTraditional
StringDigitSubstituteUser (Const) => stringDigitSubstituteUser
StringFormatFlagsDirectionRightToLeft (Const) => stringFormatFlagsDirectionRightToLeft
StringFormatFlagsDirectionVertical (Const) => stringFormatFlagsDirectionVertical
StringFormatFlagsDisplayFormatControl (Const) => stringFormatFlagsDisplayFormatControl
StringFormatFlagsLineLimit (Const) => stringFormatFlagsLineLimit
StringFormatFlagsMeasureTrailingSpaces (Const) => stringFormatFlagsMeasureTrailingSpaces
StringFormatFlagsNoClip (Const) => stringFormatFlagsNoClip
StringFormatFlagsNoFitBlackBox (Const) => stringFormatFlagsNoFitBlackBox
StringFormatFlagsNoFontFallback (Const) => stringFormatFlagsNoFontFallback
StringFormatFlagsNoWrap (Const) => stringFormatFlagsNoWrap
StringTrimmingCharacter (Const) => stringTrimmingCharacter
StringTrimmingEllipsisCharacter (Const) => stringTrimmingEllipsisCharacter
StringTrimmingEllipsisPath (Const) => stringTrimmingEllipsisPath
StringTrimmingEllipsisWord (Const) => stringTrimmingEllipsisWord
StringTrimmingNone (Const) => stringTrimmingNone
StringTrimmingWord (Const) => stringTrimmingWord
Suspended (Const) => suspended
SuspendResumeInvocation (Const) => suspendResumeInvocation
SymCoff (Const) => symCoff
SymCv (Const) => symCv
SymDeferred (Const) => symDeferred
SymDia (Const) => symDia
SymExport (Const) => symExport
SymNone (Const) => symNone
SymPdb (Const) => symPdb
SymSym (Const) => symSym
SymVirtual (Const) => symVirtual
SynchronizationEvent (Const) => synchronizationEvent
SynchronizationTimer (Const) => synchronizationTimer
Synchronize (Method) => mSynchronize
SystemBasicInformation (Const) => systemBasicInformation
SystemBatteryState (Const) => systemBatteryState
SystemExceptionInformation (Const) => systemExceptionInformation
SystemExecutionState (Const) => systemExecutionState
SystemHandleInformation (Const) => systemHandleInformation
SystemHiberbootState (Const) => systemHiberbootState
SystemHiberFileInformation (Const) => systemHiberFileInformation
SystemHiberFileSize (Const) => systemHiberFileSize
SystemInfoStream (Const) => systemInfoStream
SystemInterruptInformation (Const) => systemInterruptInformation
SystemLoad (Const) => systemLoad
SystemLookasideInformation (Const) => systemLookasideInformation
SystemMonitorHiberBootPowerOff (Const) => systemMonitorHiberBootPowerOff
SystemPagefileInformation (Const) => systemPagefileInformation
SystemPerformanceInformation (Const) => systemPerformanceInformation
SystemPowerCapabilities (Const) => systemPowerCapabilities
SystemPowerInformation (Const) => systemPowerInformation
SystemPowerLoggingEntry (Const) => systemPowerLoggingEntry
SystemPowerPolicyAc (Const) => systemPowerPolicyAc
SystemPowerPolicyCurrent (Const) => systemPowerPolicyCurrent
SystemPowerPolicyDc (Const) => systemPowerPolicyDc
SystemPowerStateHandler (Const) => systemPowerStateHandler
SystemPowerStateLogging (Const) => systemPowerStateLogging
SystemPowerStateNotifyHandler (Const) => systemPowerStateNotifyHandler
SystemProcessInformation (Const) => systemProcessInformation
SystemProcessorInformation (Const) => systemProcessorInformation
SystemProcessorPerformanceInformation (Const) => systemProcessorPerformanceInformation
SystemRegistryQuotaInformation (Const) => systemRegistryQuotaInformation
SystemReserveHiberFile (Const) => systemReserveHiberFile
SystemTimeOfDayInformation (Const) => systemTimeOfDayInformation
SystemVideoState (Const) => systemVideoState
SystemWakeSource (Const) => systemWakeSource
TapeClassGuid (Const) => tapeClassGuid
TapeDriveCleanDriveNow (Const) => tapeDriveCleanDriveNow
TapeDriveHardwareError (Const) => tapeDriveHardwareError
TapeDriveMediaLifeExpired (Const) => tapeDriveMediaLifeExpired
TapeDriveProblemNone (Const) => tapeDriveProblemNone
TapeDriveReadError (Const) => tapeDriveReadError
TapeDriveReadWarning (Const) => tapeDriveReadWarning
TapeDriveReadWriteError (Const) => tapeDriveReadWriteError
TapeDriveReadWriteWarning (Const) => tapeDriveReadWriteWarning
TapeDriveScsiConnectionError (Const) => tapeDriveScsiConnectionError
TapeDriveSnappedTape (Const) => tapeDriveSnappedTape
TapeDriveTimetoClean (Const) => tapeDriveTimetoClean
TapeDriveUnsupportedMedia (Const) => tapeDriveUnsupportedMedia
TapeDriveWriteError (Const) => tapeDriveWriteError
TapeDriveWriteWarning (Const) => tapeDriveWriteWarning
TBADDBITMAP (Object) => TTBADDBITMAP
TBREPLACEBITMAP (Object) => TTBREPLACEBITMAP
TcpBoolOptDisabled (Const) => tcpBoolOptDisabled
TcpBoolOptEnabled (Const) => tcpBoolOptEnabled
TcpBoolOptUnchanged (Const) => tcpBoolOptUnchanged
TcpConnectionEstatsBandwidth (Const) => tcpConnectionEstatsBandwidth
TcpConnectionEstatsData (Const) => tcpConnectionEstatsData
TcpConnectionEstatsFineRtt (Const) => tcpConnectionEstatsFineRtt
TcpConnectionEstatsMaximum (Const) => tcpConnectionEstatsMaximum
TcpConnectionEstatsObsRec (Const) => tcpConnectionEstatsObsRec
TcpConnectionEstatsPath (Const) => tcpConnectionEstatsPath
TcpConnectionEstatsRec (Const) => tcpConnectionEstatsRec
TcpConnectionEstatsSendBuff (Const) => tcpConnectionEstatsSendBuff
TcpConnectionEstatsSndCong (Const) => tcpConnectionEstatsSndCong
TcpConnectionEstatsSynOpts (Const) => tcpConnectionEstatsSynOpts
TcpConnectionOffloadStateInHost (Const) => tcpConnectionOffloadStateInHost
TcpConnectionOffloadStateMax (Const) => tcpConnectionOffloadStateMax
TcpConnectionOffloadStateOffloaded (Const) => tcpConnectionOffloadStateOffloaded
TcpConnectionOffloadStateOffloading (Const) => tcpConnectionOffloadStateOffloading
TcpConnectionOffloadStateUploading (Const) => tcpConnectionOffloadStateUploading
TestControlForceBilinear (Const) => testControlForceBilinear
TestControlForceNoICM (Const) => testControlForceNoICM
TestControlGetBuildNumber (Const) => testControlGetBuildNumber
TextRenderingHintAntiAlias (Const) => textRenderingHintAntiAlias
TextRenderingHintAntiAliasGridFit (Const) => textRenderingHintAntiAliasGridFit
TextRenderingHintClearTypeGridFit (Const) => textRenderingHintClearTypeGridFit
TextRenderingHintSingleBitPerPixel (Const) => textRenderingHintSingleBitPerPixel
TextRenderingHintSingleBitPerPixelGridFit (Const) => textRenderingHintSingleBitPerPixelGridFit
TextRenderingHintSystemDefault (Const) => textRenderingHintSystemDefault
THREAD_WRITE_FLAGS (Type) => TTHREAD_WRITE_FLAGS
ThreadAbsoluteCpuPriority (Const) => threadAbsoluteCpuPriority
ThreadAffinityMask (Const) => threadAffinityMask
ThreadAmILastThread (Const) => threadAmILastThread
ThreadBasePriority (Const) => threadBasePriority
ThreadBasicInformation (Const) => threadBasicInformation
ThreadCallback (Const) => threadCallback
ThreadDescriptorTableEntry (Const) => threadDescriptorTableEntry
ThreadEnableAlignmentFaultFixup (Const) => threadEnableAlignmentFaultFixup
ThreadEventPair (Const) => threadEventPair
ThreadExCallback (Const) => threadExCallback
ThreadExListStream (Const) => threadExListStream
ThreadHideFromDebugger (Const) => threadHideFromDebugger
ThreadIdealProcessor (Const) => threadIdealProcessor
ThreadImpersonationToken (Const) => threadImpersonationToken
ThreadInfoListStream (Const) => threadInfoListStream
ThreadInformationClassMax (Const) => threadInformationClassMax
ThreadIsIoPending (Const) => threadIsIoPending
ThreadListStream (Const) => threadListStream
ThreadMemoryPriority (Const) => threadMemoryPriority
ThreadPerformanceCount (Const) => threadPerformanceCount
ThreadPriority (Const) => threadPriority
ThreadPriorityBoost (Const) => threadPriorityBoost
ThreadQuerySetWin32StartAddress (Const) => threadQuerySetWin32StartAddress
ThreadSetTlsArrayAddress (Const) => threadSetTlsArrayAddress
ThreadTimes (Const) => threadTimes
ThreadWriteBackingStore (Const) => threadWriteBackingStore
ThreadWriteContext (Const) => threadWriteContext
ThreadWriteInstructionWindow (Const) => threadWriteInstructionWindow
ThreadWriteStack (Const) => threadWriteStack
ThreadWriteThread (Const) => threadWriteThread
ThreadWriteThreadData (Const) => threadWriteThreadData
ThreadWriteThreadInfo (Const) => threadWriteThreadInfo
ThreadZeroTlsCell (Const) => threadZeroTlsCell
TokenAccessInformation (Const) => tokenAccessInformation
TokenAppContainerNumber (Const) => tokenAppContainerNumber
TokenAppContainerSid (Const) => tokenAppContainerSid
TokenAuditPolicy (Const) => tokenAuditPolicy
TokenCapabilities (Const) => tokenCapabilities
TokenDefaultDacl (Const) => tokenDefaultDacl
TokenDeviceClaimAttributes (Const) => tokenDeviceClaimAttributes
TokenDeviceGroups (Const) => tokenDeviceGroups
TokenElevation (Const) => tokenElevation
TokenElevationType (Const) => tokenElevationType
TokenElevationTypeDefault (Const) => tokenElevationTypeDefault
TokenElevationTypeFull (Const) => tokenElevationTypeFull
TokenElevationTypeLimited (Const) => tokenElevationTypeLimited
TokenGroups (Const) => tokenGroups
TokenGroupsAndPrivileges (Const) => tokenGroupsAndPrivileges
TokenHasRestrictions (Const) => tokenHasRestrictions
TokenImpersonation (Const) => tokenImpersonation
TokenImpersonationLevel (Const) => tokenImpersonationLevel
TokenIntegrityLevel (Const) => tokenIntegrityLevel
TokenIsAppContainer (Const) => tokenIsAppContainer
TokenIsRestricted (Const) => tokenIsRestricted
TokenLinkedToken (Const) => tokenLinkedToken
TokenLogonSid (Const) => tokenLogonSid
TokenMandatoryPolicy (Const) => tokenMandatoryPolicy
TokenOrigin (Const) => tokenOrigin
TokenOwner (Const) => tokenOwner
TokenPrimary (Const) => tokenPrimary
TokenPrimaryGroup (Const) => tokenPrimaryGroup
TokenPrivileges (Const) => tokenPrivileges
TokenRestrictedDeviceClaimAttributes (Const) => tokenRestrictedDeviceClaimAttributes
TokenRestrictedDeviceGroups (Const) => tokenRestrictedDeviceGroups
TokenRestrictedSids (Const) => tokenRestrictedSids
TokenRestrictedUserClaimAttributes (Const) => tokenRestrictedUserClaimAttributes
TokenSandBoxInert (Const) => tokenSandBoxInert
TokenSecurityAttributes (Const) => tokenSecurityAttributes
TokenSessionId (Const) => tokenSessionId
TokenSessionReference (Const) => tokenSessionReference
TokenSource (Const) => tokenSource
TokenStatistics (Const) => tokenStatistics
TokenStream (Const) => tokenStream
TokenType (Const) => tokenType
TokenUIAccess (Const) => tokenUIAccess
TokenUser (Const) => tokenUser
TokenUserClaimAttributes (Const) => tokenUserClaimAttributes
TokenVirtualizationAllowed (Const) => tokenVirtualizationAllowed
TokenVirtualizationEnabled (Const) => tokenVirtualizationEnabled
ToleranceHigh (Const) => toleranceHigh
ToleranceIntervalLong (Const) => toleranceIntervalLong
ToleranceIntervalMedium (Const) => toleranceIntervalMedium
ToleranceIntervalShort (Const) => toleranceIntervalShort
ToleranceLow (Const) => toleranceLow
ToleranceMedium (Const) => toleranceMedium
TRACE_VERSION (Const) => traceVersion
TraceApplicationPowerMessage (Const) => traceApplicationPowerMessage
TraceApplicationPowerMessageEnd (Const) => traceApplicationPowerMessageEnd
TraceServicePowerMessage (Const) => traceServicePowerMessage
TRACKMOUSEEVENT (Object) => TTRACKMOUSEEVENT
TransactionBasicInformation (Const) => transactionBasicInformation
TransactionBindInformation (Const) => transactionBindInformation
TransactionDTCPrivateInformation (Const) => transactionDTCPrivateInformation
TransactionEnlistmentInformation (Const) => transactionEnlistmentInformation
TransactionManagerBasicInformation (Const) => transactionManagerBasicInformation
TransactionManagerLogInformation (Const) => transactionManagerLogInformation
TransactionManagerLogPathInformation (Const) => transactionManagerLogPathInformation
TransactionManagerOldestTransactionInformation (Const) => transactionManagerOldestTransactionInformation
TransactionManagerOnlineProbeInformation (Const) => transactionManagerOnlineProbeInformation
TransactionManagerRecoveryInformation (Const) => transactionManagerRecoveryInformation
TransactionOutcomeAborted (Const) => transactionOutcomeAborted
TransactionOutcomeCommitted (Const) => transactionOutcomeCommitted
TransactionOutcomeUndetermined (Const) => transactionOutcomeUndetermined
TransactionPropertiesInformation (Const) => transactionPropertiesInformation
TransactionStateCommittedNotify (Const) => transactionStateCommittedNotify
TransactionStateIndoubt (Const) => transactionStateIndoubt
TransactionStateNormal (Const) => transactionStateNormal
TransactionSuperiorEnlistmentInformation (Const) => transactionSuperiorEnlistmentInformation
Travan (Const) => travan
TrustedControllersInformation (Const) => trustedControllersInformation
TrustedDomainAuthInformation (Const) => trustedDomainAuthInformation
TrustedDomainAuthInformationInternal (Const) => trustedDomainAuthInformationInternal
TrustedDomainFullInformation (Const) => trustedDomainFullInformation
TrustedDomainFullInformation2Internal (Const) => trustedDomainFullInformation2Internal
TrustedDomainFullInformationInternal (Const) => trustedDomainFullInformationInternal
TrustedDomainInformationBasic (Const) => trustedDomainInformationBasic
TrustedDomainInformationEx (Const) => trustedDomainInformationEx
TrustedDomainInformationEx2Internal (Const) => trustedDomainInformationEx2Internal
TrustedDomainNameInformation (Const) => trustedDomainNameInformation
TrustedPasswordInformation (Const) => trustedPasswordInformation
TrustedPosixOffsetInformation (Const) => trustedPosixOffsetInformation
TRUSTEE_ (Type) => TRUSTEE
UiaAppendRuntimeId (Const) => uiaAppendRuntimeId
UiaRootObjectId (Const) => uiaRootObjectId
UmsSchedulerStartup (Const) => umsSchedulerStartup
UmsSchedulerThreadBlocked (Const) => umsSchedulerThreadBlocked
UmsSchedulerThreadYield (Const) => umsSchedulerThreadYield
UmsThreadAffinity (Const) => umsThreadAffinity
UmsThreadInvalidInfoClass (Const) => umsThreadInvalidInfoClass
UmsThreadIsSuspended (Const) => umsThreadIsSuspended
UmsThreadIsTerminated (Const) => umsThreadIsTerminated
UmsThreadMaxInfoClass (Const) => umsThreadMaxInfoClass
UmsThreadPriority (Const) => umsThreadPriority
UmsThreadTeb (Const) => umsThreadTeb
UmsThreadUserContext (Const) => umsThreadUserContext
Unit (Type) => GpUnit
UnitDisplay (Const) => unitDisplay
UnitDocument (Const) => unitDocument
UnitInch (Const) => unitInch
UnitMillimeter (Const) => unitMillimeter
UnitPixel (Const) => unitPixel
UnitPoint (Const) => unitPoint
UnitWorld (Const) => unitWorld
Unknown (Const) => unknown
UnknownImageFormat (Const) => unknownImageFormat
UnloadedModuleListStream (Const) => unloadedModuleListStream
Unlock (Const) => unlock
UnsupportedGdiplusVersion (Const) => unsupportedGdiplusVersion
UnusedStream (Const) => unusedStream
URL_UNESCAPE (Const) => urlUnescape
URLIS (Type) => TURLIS
URLIS_APPLIABLE (Const) => urlIsAppliable
URLIS_DIRECTORY (Const) => urlIsDirectory
URLIS_FILEURL (Const) => urlIsFileurl
URLIS_HASQUERY (Const) => urlIsHasquery
URLIS_NOHISTORY (Const) => urlIsNohistory
URLIS_OPAQUE (Const) => urlIsOpaque
URLIS_URL (Const) => urlIsUrl
UsernameTargetCredential (Const) => usernameTargetCredential
UserNotPresent (Const) => userNotPresent
UserPresence (Const) => userPresence
UserPresent (Const) => userPresent
UserRequest (Const) => userRequest
UserUnknown (Const) => userUnknown
ValueOverflow (Const) => valueOverflow
VerifyProcessorPowerPolicyAc (Const) => verifyProcessorPowerPolicyAc
VerifyProcessorPowerPolicyDc (Const) => verifyProcessorPowerPolicyDc
VerifySystemPolicyAc (Const) => verifySystemPolicyAc
VerifySystemPolicyDc (Const) => verifySystemPolicyDc
VmOfferPriorityBelowNormal (Const) => vmOfferPriorityBelowNormal
VmOfferPriorityLow (Const) => vmOfferPriorityLow
VmOfferPriorityNormal (Const) => vmOfferPriorityNormal
VmOfferPriorityVeryLow (Const) => vmOfferPriorityVeryLow
VolumeClassGuid (Const) => volumeClassGuid
VOS__BASE (Const) => VOS_BASE
VOS__PM16 (Const) => VOS_PM16
VOS__PM32 (Const) => VOS_PM32
VOS__WINDOWS16 (Const) => VOS_WINDOWS16
VOS__WINDOWS32 (Const) => VOS_WINDOWS32
VXATape (Const) => vXATape
WaitAll (Const) => waitAll
WaitAny (Const) => waitAny
WakeTimerList (Const) => wakeTimerList
WarpModeBilinear (Const) => warpModeBilinear
WarpModePerspective (Const) => warpModePerspective
WAVEFORMATEXTENSIBLE (Object) => TWAVEFORMATEXTENSIBLE
WICBitmapCacheOnDemand (Const) => wICBitmapCacheOnDemand
WICBitmapCacheOnLoad (Const) => wICBitmapCacheOnLoad
WICBitmapDecoderCapabilityCanDecodeAllImages (Const) => wICBitmapDecoderCapabilityCanDecodeAllImages
WICBitmapDecoderCapabilityCanDecodeSomeImages (Const) => wICBitmapDecoderCapabilityCanDecodeSomeImages
WICBitmapDecoderCapabilityCanDecodeThumbnail (Const) => wICBitmapDecoderCapabilityCanDecodeThumbnail
WICBitmapDecoderCapabilityCanEnumerateMetadata (Const) => wICBitmapDecoderCapabilityCanEnumerateMetadata
WICBitmapDecoderCapabilitySameEncoder (Const) => wICBitmapDecoderCapabilitySameEncoder
WICBitmapDitherTypeDualSpiral4x4 (Const) => wICBitmapDitherTypeDualSpiral4x4
WICBitmapDitherTypeDualSpiral8x8 (Const) => wICBitmapDitherTypeDualSpiral8x8
WICBitmapDitherTypeErrorDiffusion (Const) => wICBitmapDitherTypeErrorDiffusion
WICBitmapDitherTypeNone (Const) => wICBitmapDitherTypeNone
WICBitmapDitherTypeOrdered16x16 (Const) => wICBitmapDitherTypeOrdered16x16
WICBitmapDitherTypeOrdered4x4 (Const) => wICBitmapDitherTypeOrdered4x4
WICBitmapDitherTypeOrdered8x8 (Const) => wICBitmapDitherTypeOrdered8x8
WICBitmapDitherTypeSolid (Const) => wICBitmapDitherTypeSolid
WICBitmapDitherTypeSpiral4x4 (Const) => wICBitmapDitherTypeSpiral4x4
WICBitmapDitherTypeSpiral8x8 (Const) => wICBitmapDitherTypeSpiral8x8
WICBitmapEncoderCacheInMemory (Const) => wICBitmapEncoderCacheInMemory
WICBitmapEncoderCacheTempFile (Const) => wICBitmapEncoderCacheTempFile
WICBitmapEncoderNoCache (Const) => wICBitmapEncoderNoCache
WICBitmapIgnoreAlpha (Const) => wICBitmapIgnoreAlpha
WICBitmapInterpolationModeCubic (Const) => wICBitmapInterpolationModeCubic
WICBitmapInterpolationModeFant (Const) => wICBitmapInterpolationModeFant
WICBitmapInterpolationModeLinear (Const) => wICBitmapInterpolationModeLinear
WICBitmapInterpolationModeNearestNeighbor (Const) => wICBitmapInterpolationModeNearestNeighbor
WICBitmapLockRead (Const) => wICBitmapLockRead
WICBitmapLockWrite (Const) => wICBitmapLockWrite
WICBitmapNoCache (Const) => wICBitmapNoCache
WICBitmapPaletteTypeCustom (Const) => wICBitmapPaletteTypeCustom
WICBitmapPaletteTypeFixedBW (Const) => wICBitmapPaletteTypeFixedBW
WICBitmapPaletteTypeFixedGray16 (Const) => wICBitmapPaletteTypeFixedGray16
WICBitmapPaletteTypeFixedGray256 (Const) => wICBitmapPaletteTypeFixedGray256
WICBitmapPaletteTypeFixedGray4 (Const) => wICBitmapPaletteTypeFixedGray4
WICBitmapPaletteTypeFixedHalftone125 (Const) => wICBitmapPaletteTypeFixedHalftone125
WICBitmapPaletteTypeFixedHalftone216 (Const) => wICBitmapPaletteTypeFixedHalftone216
WICBitmapPaletteTypeFixedHalftone252 (Const) => wICBitmapPaletteTypeFixedHalftone252
WICBitmapPaletteTypeFixedHalftone256 (Const) => wICBitmapPaletteTypeFixedHalftone256
WICBitmapPaletteTypeFixedHalftone27 (Const) => wICBitmapPaletteTypeFixedHalftone27
WICBitmapPaletteTypeFixedHalftone64 (Const) => wICBitmapPaletteTypeFixedHalftone64
WICBitmapPaletteTypeFixedHalftone8 (Const) => wICBitmapPaletteTypeFixedHalftone8
WICBitmapPaletteTypeFixedWebPalette (Const) => wICBitmapPaletteTypeFixedWebPalette
WICBitmapPaletteTypeMedianCut (Const) => wICBitmapPaletteTypeMedianCut
WICBitmapTransformFlipHorizontal (Const) => wICBitmapTransformFlipHorizontal
WICBitmapTransformFlipVertical (Const) => wICBitmapTransformFlipVertical
WICBitmapTransformRotate0 (Const) => wICBitmapTransformRotate0
WICBitmapTransformRotate180 (Const) => wICBitmapTransformRotate180
WICBitmapTransformRotate270 (Const) => wICBitmapTransformRotate270
WICBitmapTransformRotate90 (Const) => wICBitmapTransformRotate90
WICBitmapUseAlpha (Const) => wICBitmapUseAlpha
WICBitmapUsePremultipliedAlpha (Const) => wICBitmapUsePremultipliedAlpha
WICColorContextExifColorSpace (Const) => wICColorContextExifColorSpace
WICColorContextProfile (Const) => wICColorContextProfile
WICColorContextUninitialized (Const) => wICColorContextUninitialized
WICComponentDisabled (Const) => wICComponentDisabled
WICComponentEnumerateBuiltInOnly (Const) => wICComponentEnumerateBuiltInOnly
WICComponentEnumerateDefault (Const) => wICComponentEnumerateDefault
WICComponentEnumerateDisabled (Const) => wICComponentEnumerateDisabled
WICComponentEnumerateRefresh (Const) => wICComponentEnumerateRefresh
WICComponentEnumerateUnsigned (Const) => wICComponentEnumerateUnsigned
WICComponentSafe (Const) => wICComponentSafe
WICComponentSigned (Const) => wICComponentSigned
WICComponentUnsigned (Const) => wICComponentUnsigned
WICDecodeMetadataCacheOnDemand (Const) => wICDecodeMetadataCacheOnDemand
WICDecodeMetadataCacheOnLoad (Const) => wICDecodeMetadataCacheOnLoad
WICDecoder (Const) => wICDecoder
WICEncoder (Const) => wICEncoder
WICMetadataReader (Const) => wICMetadataReader
WICMetadataWriter (Const) => wICMetadataWriter
WICPixelFormat (Const) => wICPixelFormat
WICPixelFormatConverter (Const) => wICPixelFormatConverter
WICPixelFormatNumericRepresentationFixed (Const) => wICPixelFormatNumericRepresentationFixed
WICPixelFormatNumericRepresentationFloat (Const) => wICPixelFormatNumericRepresentationFloat
WICPixelFormatNumericRepresentationIndexed (Const) => wICPixelFormatNumericRepresentationIndexed
WICPixelFormatNumericRepresentationSignedInteger (Const) => wICPixelFormatNumericRepresentationSignedInteger
WICPixelFormatNumericRepresentationUnsignedInteger (Const) => wICPixelFormatNumericRepresentationUnsignedInteger
WICPixelFormatNumericRepresentationUnspecified (Const) => wICPixelFormatNumericRepresentationUnspecified
WICTiffCompressionCCITT3 (Const) => wICTiffCompressionCCITT3
WICTiffCompressionCCITT4 (Const) => wICTiffCompressionCCITT4
WICTiffCompressionDontCare (Const) => wICTiffCompressionDontCare
WICTiffCompressionLZW (Const) => wICTiffCompressionLZW
WICTiffCompressionLZWHDifferencing (Const) => wICTiffCompressionLZWHDifferencing
WICTiffCompressionNone (Const) => wICTiffCompressionNone
WICTiffCompressionRLE (Const) => wICTiffCompressionRLE
WICTiffCompressionZIP (Const) => wICTiffCompressionZIP
Win32Error (Const) => win32Error
Win32ServiceOwnProcess (Const) => win32ServiceOwnProcess
Win32ServiceShareProcess (Const) => win32ServiceShareProcess
WinAccountAdministratorSid (Const) => winAccountAdministratorSid
WinAccountCertAdminsSid (Const) => winAccountCertAdminsSid
WinAccountCloneableControllersSid (Const) => winAccountCloneableControllersSid
WinAccountComputersSid (Const) => winAccountComputersSid
WinAccountControllersSid (Const) => winAccountControllersSid
WinAccountDomainAdminsSid (Const) => winAccountDomainAdminsSid
WinAccountDomainGuestsSid (Const) => winAccountDomainGuestsSid
WinAccountDomainUsersSid (Const) => winAccountDomainUsersSid
WinAccountEnterpriseAdminsSid (Const) => winAccountEnterpriseAdminsSid
WinAccountGuestSid (Const) => winAccountGuestSid
WinAccountKrbtgtSid (Const) => winAccountKrbtgtSid
WinAccountPolicyAdminsSid (Const) => winAccountPolicyAdminsSid
WinAccountRasAndIasServersSid (Const) => winAccountRasAndIasServersSid
WinAccountReadonlyControllersSid (Const) => winAccountReadonlyControllersSid
WinAccountSchemaAdminsSid (Const) => winAccountSchemaAdminsSid
WinAnonymousSid (Const) => winAnonymousSid
WinApplicationPackageAuthoritySid (Const) => winApplicationPackageAuthoritySid
WinAuthenticatedUserSid (Const) => winAuthenticatedUserSid
WinAuthenticationAuthorityAssertedSid (Const) => winAuthenticationAuthorityAssertedSid
WinAuthenticationServiceAssertedSid (Const) => winAuthenticationServiceAssertedSid
WinBatchSid (Const) => winBatchSid
WinBuiltinAccessControlAssistanceOperatorsSid (Const) => winBuiltinAccessControlAssistanceOperatorsSid
WinBuiltinAccountOperatorsSid (Const) => winBuiltinAccountOperatorsSid
WinBuiltinAdministratorsSid (Const) => winBuiltinAdministratorsSid
WinBuiltinAnyPackageSid (Const) => winBuiltinAnyPackageSid
WinBuiltinAuthorizationAccessSid (Const) => winBuiltinAuthorizationAccessSid
WinBuiltinBackupOperatorsSid (Const) => winBuiltinBackupOperatorsSid
WinBuiltinCertSvcDComAccessGroup (Const) => winBuiltinCertSvcDComAccessGroup
WinBuiltinCryptoOperatorsSid (Const) => winBuiltinCryptoOperatorsSid
WinBuiltinDCOMUsersSid (Const) => winBuiltinDCOMUsersSid
WinBuiltinDomainSid (Const) => winBuiltinDomainSid
WinBuiltinEventLogReadersGroup (Const) => winBuiltinEventLogReadersGroup
WinBuiltinGuestsSid (Const) => winBuiltinGuestsSid
WinBuiltinHyperVAdminsSid (Const) => winBuiltinHyperVAdminsSid
WinBuiltinIncomingForestTrustBuildersSid (Const) => winBuiltinIncomingForestTrustBuildersSid
WinBuiltinIUsersSid (Const) => winBuiltinIUsersSid
WinBuiltinNetworkConfigurationOperatorsSid (Const) => winBuiltinNetworkConfigurationOperatorsSid
WinBuiltinPerfLoggingUsersSid (Const) => winBuiltinPerfLoggingUsersSid
WinBuiltinPerfMonitoringUsersSid (Const) => winBuiltinPerfMonitoringUsersSid
WinBuiltinPowerUsersSid (Const) => winBuiltinPowerUsersSid
WinBuiltinPreWindows2000CompatibleAccessSid (Const) => winBuiltinPreWindows2000CompatibleAccessSid
WinBuiltinPrintOperatorsSid (Const) => winBuiltinPrintOperatorsSid
WinBuiltinRDSEndpointServersSid (Const) => winBuiltinRDSEndpointServersSid
WinBuiltinRDSManagementServersSid (Const) => winBuiltinRDSManagementServersSid
WinBuiltinRDSRemoteAccessServersSid (Const) => winBuiltinRDSRemoteAccessServersSid
WinBuiltinRemoteDesktopUsersSid (Const) => winBuiltinRemoteDesktopUsersSid
WinBuiltinRemoteManagementUsersSid (Const) => winBuiltinRemoteManagementUsersSid
WinBuiltinReplicatorSid (Const) => winBuiltinReplicatorSid
WinBuiltinSystemOperatorsSid (Const) => winBuiltinSystemOperatorsSid
WinBuiltinTerminalServerLicenseServersSid (Const) => winBuiltinTerminalServerLicenseServersSid
WinBuiltinUsersSid (Const) => winBuiltinUsersSid
WinCacheablePrincipalsGroupSid (Const) => winCacheablePrincipalsGroupSid
WinCapabilityDocumentsLibrarySid (Const) => winCapabilityDocumentsLibrarySid
WinCapabilityEnterpriseAuthenticationSid (Const) => winCapabilityEnterpriseAuthenticationSid
WinCapabilityInternetClientServerSid (Const) => winCapabilityInternetClientServerSid
WinCapabilityInternetClientSid (Const) => winCapabilityInternetClientSid
WinCapabilityMusicLibrarySid (Const) => winCapabilityMusicLibrarySid
WinCapabilityPicturesLibrarySid (Const) => winCapabilityPicturesLibrarySid
WinCapabilityPrivateNetworkClientServerSid (Const) => winCapabilityPrivateNetworkClientServerSid
WinCapabilityRemovableStorageSid (Const) => winCapabilityRemovableStorageSid
WinCapabilitySharedUserCertificatesSid (Const) => winCapabilitySharedUserCertificatesSid
WinCapabilityVideosLibrarySid (Const) => winCapabilityVideosLibrarySid
WinConsoleLogonSid (Const) => winConsoleLogonSid
WinCreatorGroupServerSid (Const) => winCreatorGroupServerSid
WinCreatorGroupSid (Const) => winCreatorGroupSid
WinCreatorOwnerRightsSid (Const) => winCreatorOwnerRightsSid
WinCreatorOwnerServerSid (Const) => winCreatorOwnerServerSid
WinCreatorOwnerSid (Const) => winCreatorOwnerSid
WinDialupSid (Const) => winDialupSid
WinDigestAuthenticationSid (Const) => winDigestAuthenticationSid
WinEnterpriseControllersSid (Const) => winEnterpriseControllersSid
WinEnterpriseReadonlyControllersSid (Const) => winEnterpriseReadonlyControllersSid
WinHighLabelSid (Const) => winHighLabelSid
WinInteractiveSid (Const) => winInteractiveSid
WinIUserSid (Const) => winIUserSid
WinLocalLogonSid (Const) => winLocalLogonSid
WinLocalServiceSid (Const) => winLocalServiceSid
WinLocalSid (Const) => winLocalSid
WinLocalSystemSid (Const) => winLocalSystemSid
WinLogonIdsSid (Const) => winLogonIdsSid
WinLowLabelSid (Const) => winLowLabelSid
WinMediumLabelSid (Const) => winMediumLabelSid
WinMediumPlusLabelSid (Const) => winMediumPlusLabelSid
WinNetworkServiceSid (Const) => winNetworkServiceSid
WinNetworkSid (Const) => winNetworkSid
WinNewEnterpriseReadonlyControllersSid (Const) => winNewEnterpriseReadonlyControllersSid
WinNonCacheablePrincipalsGroupSid (Const) => winNonCacheablePrincipalsGroupSid
WinNtAuthoritySid (Const) => winNtAuthoritySid
WinNTLMAuthenticationSid (Const) => winNTLMAuthenticationSid
WinNullSid (Const) => winNullSid
WinOtherOrganizationSid (Const) => winOtherOrganizationSid
WinProxySid (Const) => winProxySid
WinRemoteLogonIdSid (Const) => winRemoteLogonIdSid
WinRestrictedCodeSid (Const) => winRestrictedCodeSid
WinSChannelAuthenticationSid (Const) => winSChannelAuthenticationSid
WinSelfSid (Const) => winSelfSid
WinServiceSid (Const) => winServiceSid
WinStationInformation (Const) => winStationInformation
WinSystemLabelSid (Const) => winSystemLabelSid
WinTerminalServerSid (Const) => winTerminalServerSid
WinThisOrganizationCertificateSid (Const) => winThisOrganizationCertificateSid
WinThisOrganizationSid (Const) => winThisOrganizationSid
WinUntrustedLabelSid (Const) => winUntrustedLabelSid
WinUserModeDriversSid (Const) => winUserModeDriversSid
WinWorldSid (Const) => winWorldSid
WinWriteRestrictedCodeSid (Const) => winWriteRestrictedCodeSid
WmfRecordTypeAbortDoc (Const) => wmfRecordTypeAbortDoc
WmfRecordTypeAnimatePalette (Const) => wmfRecordTypeAnimatePalette
WmfRecordTypeArc (Const) => wmfRecordTypeArc
WmfRecordTypeBitBlt (Const) => wmfRecordTypeBitBlt
WmfRecordTypeChord (Const) => wmfRecordTypeChord
WmfRecordTypeCreateBitmap (Const) => wmfRecordTypeCreateBitmap
WmfRecordTypeCreateBitmapIndirect (Const) => wmfRecordTypeCreateBitmapIndirect
WmfRecordTypeCreateBrush (Const) => wmfRecordTypeCreateBrush
WmfRecordTypeCreateBrushIndirect (Const) => wmfRecordTypeCreateBrushIndirect
WmfRecordTypeCreateFontIndirect (Const) => wmfRecordTypeCreateFontIndirect
WmfRecordTypeCreatePalette (Const) => wmfRecordTypeCreatePalette
WmfRecordTypeCreatePatternBrush (Const) => wmfRecordTypeCreatePatternBrush
WmfRecordTypeCreatePenIndirect (Const) => wmfRecordTypeCreatePenIndirect
WmfRecordTypeCreateRegion (Const) => wmfRecordTypeCreateRegion
WmfRecordTypeDeleteObject (Const) => wmfRecordTypeDeleteObject
WmfRecordTypeDIBBitBlt (Const) => wmfRecordTypeDIBBitBlt
WmfRecordTypeDIBCreatePatternBrush (Const) => wmfRecordTypeDIBCreatePatternBrush
WmfRecordTypeDIBStretchBlt (Const) => wmfRecordTypeDIBStretchBlt
WmfRecordTypeDrawText (Const) => wmfRecordTypeDrawText
WmfRecordTypeEllipse (Const) => wmfRecordTypeEllipse
WmfRecordTypeEndDoc (Const) => wmfRecordTypeEndDoc
WmfRecordTypeEndPage (Const) => wmfRecordTypeEndPage
WmfRecordTypeEscape (Const) => wmfRecordTypeEscape
WmfRecordTypeExcludeClipRect (Const) => wmfRecordTypeExcludeClipRect
WmfRecordTypeExtFloodFill (Const) => wmfRecordTypeExtFloodFill
WmfRecordTypeExtTextOut (Const) => wmfRecordTypeExtTextOut
WmfRecordTypeFillRegion (Const) => wmfRecordTypeFillRegion
WmfRecordTypeFloodFill (Const) => wmfRecordTypeFloodFill
WmfRecordTypeFrameRegion (Const) => wmfRecordTypeFrameRegion
WmfRecordTypeIntersectClipRect (Const) => wmfRecordTypeIntersectClipRect
WmfRecordTypeInvertRegion (Const) => wmfRecordTypeInvertRegion
WmfRecordTypeLineTo (Const) => wmfRecordTypeLineTo
WmfRecordTypeMoveTo (Const) => wmfRecordTypeMoveTo
WmfRecordTypeOffsetClipRgn (Const) => wmfRecordTypeOffsetClipRgn
WmfRecordTypeOffsetViewportOrg (Const) => wmfRecordTypeOffsetViewportOrg
WmfRecordTypeOffsetWindowOrg (Const) => wmfRecordTypeOffsetWindowOrg
WmfRecordTypePaintRegion (Const) => wmfRecordTypePaintRegion
WmfRecordTypePatBlt (Const) => wmfRecordTypePatBlt
WmfRecordTypePie (Const) => wmfRecordTypePie
WmfRecordTypePolygon (Const) => wmfRecordTypePolygon
WmfRecordTypePolyline (Const) => wmfRecordTypePolyline
WmfRecordTypePolyPolygon (Const) => wmfRecordTypePolyPolygon
WmfRecordTypeRealizePalette (Const) => wmfRecordTypeRealizePalette
WmfRecordTypeRectangle (Const) => wmfRecordTypeRectangle
WmfRecordTypeResetDC (Const) => wmfRecordTypeResetDC
WmfRecordTypeResizePalette (Const) => wmfRecordTypeResizePalette
WmfRecordTypeRestoreDC (Const) => wmfRecordTypeRestoreDC
WmfRecordTypeRoundRect (Const) => wmfRecordTypeRoundRect
WmfRecordTypeSaveDC (Const) => wmfRecordTypeSaveDC
WmfRecordTypeScaleViewportExt (Const) => wmfRecordTypeScaleViewportExt
WmfRecordTypeScaleWindowExt (Const) => wmfRecordTypeScaleWindowExt
WmfRecordTypeSelectClipRegion (Const) => wmfRecordTypeSelectClipRegion
WmfRecordTypeSelectObject (Const) => wmfRecordTypeSelectObject
WmfRecordTypeSelectPalette (Const) => wmfRecordTypeSelectPalette
WmfRecordTypeSetBkColor (Const) => wmfRecordTypeSetBkColor
WmfRecordTypeSetBkMode (Const) => wmfRecordTypeSetBkMode
WmfRecordTypeSetDIBToDev (Const) => wmfRecordTypeSetDIBToDev
WmfRecordTypeSetLayout (Const) => wmfRecordTypeSetLayout
WmfRecordTypeSetMapMode (Const) => wmfRecordTypeSetMapMode
WmfRecordTypeSetMapperFlags (Const) => wmfRecordTypeSetMapperFlags
WmfRecordTypeSetPalEntries (Const) => wmfRecordTypeSetPalEntries
WmfRecordTypeSetPixel (Const) => wmfRecordTypeSetPixel
WmfRecordTypeSetPolyFillMode (Const) => wmfRecordTypeSetPolyFillMode
WmfRecordTypeSetRelAbs (Const) => wmfRecordTypeSetRelAbs
WmfRecordTypeSetROP2 (Const) => wmfRecordTypeSetROP2
WmfRecordTypeSetStretchBltMode (Const) => wmfRecordTypeSetStretchBltMode
WmfRecordTypeSetTextAlign (Const) => wmfRecordTypeSetTextAlign
WmfRecordTypeSetTextCharExtra (Const) => wmfRecordTypeSetTextCharExtra
WmfRecordTypeSetTextColor (Const) => wmfRecordTypeSetTextColor
WmfRecordTypeSetTextJustification (Const) => wmfRecordTypeSetTextJustification
WmfRecordTypeSetViewportExt (Const) => wmfRecordTypeSetViewportExt
WmfRecordTypeSetViewportOrg (Const) => wmfRecordTypeSetViewportOrg
WmfRecordTypeSetWindowExt (Const) => wmfRecordTypeSetWindowExt
WmfRecordTypeSetWindowOrg (Const) => wmfRecordTypeSetWindowOrg
WmfRecordTypeStartDoc (Const) => wmfRecordTypeStartDoc
WmfRecordTypeStartPage (Const) => wmfRecordTypeStartPage
WmfRecordTypeStretchBlt (Const) => wmfRecordTypeStretchBlt
WmfRecordTypeStretchDIB (Const) => wmfRecordTypeStretchDIB
WmfRecordTypeTextOut (Const) => wmfRecordTypeTextOut
WrapMode (Type) => GpWrapMode
WrapModeClamp (Const) => wrapModeClamp
WrapModeTile (Const) => wrapModeTile
WrapModeTileFlipX (Const) => wrapModeTileFlipX
WrapModeTileFlipXY (Const) => wrapModeTileFlipXY
WrapModeTileFlipY (Const) => wrapModeTileFlipY
WrDelayExecution (Const) => wrDelayExecution
WrEventPair (Const) => wrEventPair
WrExecutive (Const) => wrExecutive
WrFreePage (Const) => wrFreePage
WriteCacheChangeable (Const) => writeCacheChangeable
WriteCacheChangeUnknown (Const) => writeCacheChangeUnknown
WriteCacheDisabled (Const) => writeCacheDisabled
WriteCacheEnabled (Const) => writeCacheEnabled
WriteCacheEnableUnknown (Const) => writeCacheEnableUnknown
WriteCacheNotChangeable (Const) => writeCacheNotChangeable
WriteCacheTypeNone (Const) => writeCacheTypeNone
WriteCacheTypeUnknown (Const) => writeCacheTypeUnknown
WriteCacheTypeWriteBack (Const) => writeCacheTypeWriteBack
WriteCacheTypeWriteThrough (Const) => writeCacheTypeWriteThrough
WriteKernelMinidumpCallback (Const) => writeKernelMinidumpCallback
WriteOnceDiskClassGuid (Const) => writeOnceDiskClassGuid
WriteThroughNotSupported (Const) => writeThroughNotSupported
WriteThroughSupported (Const) => writeThroughSupported
WriteThroughUnknown (Const) => writeThroughUnknown
WrKernel (Const) => wrKernel
WrLpcReceive (Const) => wrLpcReceive
WrLpcReply (Const) => wrLpcReply
WrongState (Const) => wrongState
WrPageIn (Const) => wrPageIn
WrPageOut (Const) => wrPageOut
WrPoolAllocation (Const) => wrPoolAllocation
WrQueue (Const) => wrQueue
WrRendezvous (Const) => wrRendezvous
WrSuspended (Const) => wrSuspended
WrUserRequest (Const) => wrUserRequest
WrVirtualMemory (Const) => wrVirtualMemory
WSASENDMSG (Object) => TWSASENDMSG
